Albert Einstein	Wàll:Jëmm;
Ndakaaru	Wàll:Dëkki Senegaal;Wàll:Péy;
ANAFA	Wàll:mbootaay yu Senegal;
End	Wàll:Réew;Wàll:Asi;Wàll:End;
Royuwaay:Diiney kirist	:Wàll:Nit ñi ci Kàddug Yàlla|Nit ñi ci Kàddug Yàlla;Wàll:Royuwaay diine;
Senegaal	Wàll:Afrig;Wàll:Réew;Wàll:Senegaal| ;
Limu réewi àdduna bi	Wàll:Melosuuf;Wàll:Réew|*Réewi;
Faraas	Wàll:Faraas| ;Wàll:Tugal;Wàll:Réew;
Gànnaar	Wàll:Réew;Wàll:Afrig;Wàll:Gànnaar;
Bene	Wàll:Réew;Wàll:Afrig;Wàll:Bene| ;
Gàmbi	Wàll:Réew;Wàll:Afrig;Wàll:Gàmbi;
Mali	Wàll:Réew;Wàll:Afrig;
Gine	Wàll:Réew;Wàll:Afrig;
Belsik	Wàll:Réew;Wàll:Tugal;Wàll:Beljik;
Burkinaa Faaso	Wàll:Afrig;Wàll:Réew;Wàll:Burkinaa Faaso;
Kamerun	Wàll:Kamerun;Wàll:Afrig;Wàll:Réew;
Danmaark	Wàll:Réew;Wàll:Tugal;Wàll:Danmaark;
Marok	Wàll:Réew;Wàll:Afrig;
Kap Weert	Wàll:Réew;Wàll:Afrig;Wàll:Kap Weer;
Afganistaan	Wàll:Réew;Wàll:Asi;Wàll:Afganistaan;
Albaani	Wàll:Réew;Wàll:Tugal;Wàll:Albaani;
Alseeri	Wàll:Réew;Wàll:Afrig;Wàll:Alseeri| ;
Andoor	Wàll:Réew;Wàll:Tugal;Wàll:Andoor;
Angolaa	Wàll:Réew;Wàll:Afrig;Wàll:Angolaa| ;
Arsantin	Wàll:Réew;Wàll:Aamerig;Wàll:Arsantin| ;
Armeeni	Wàll:Réew;Wàll:Tugal;Wàll:Asi;Wàll:Armeeni;
Otris	Wàll:Réew;Wàll:Tugal;Wàll:Ótiris| ;
Aserbayjaan	Wàll:Aserbayjaan| ;Wàll:Réew;Wàll:Tugal;Wàll:Asi;
Bahamas	Wàll:Aamerig;Wàll:Réew;
Bahrayni	Wàll:Réew;Wàll:Asi;Wàll:Bahrayni| ;
Barbados	Wàll:Aamerig;Wàll:Réew;
Belaarus	Wàll:Réew;Wàll:Tugal;Wàll:Belaarus|*;
Butaan	Wàll:Réew;Wàll:Asi;
Boliibi	Wàll:Réew;Wàll:Aamerig;Wàll:Boliibi| ;
Bosni	Wàll:Réew;Wàll:Tugal;Wàll:Bosni;
Botswana	Wàll:Réew;Wàll:Afrig;Wàll:Botswana| ;
Dunu Aland	Wàll:Réew;
Angila	Wàll:Réew;Wàll:Angila;
Aruba	Wàll:Réew;Wàll:Olaand;
Óstraali	Wàll:Diwaani oseyaani;Wàll:Réew;Wàll:Óstraali;
Breesil	Wàll:Réew;Wàll:Aamerig;Wàll:Breesil|*;
Bulgaari	Wàll:Réew;Wàll:Tugal;Wàll:Bulgaari|*;
Buruundi	Wàll:Réew;Wàll:Afrig;Wàll:Buruundi;
Kamboodi	Wàll:Réew;Wàll:Asi;
Banglaades	Wàll:Asi;Wàll:Réew;Wàll:Banglaades;
Beliis	Wàll:Aamerig;Wàll:Réew;
Bermuda	Wàll:Aamerig;Wàll:Nguur-Yu-Bennoo;
Kanadaa	Wàll:Kanadaa| ;Wàll:Réew;Wàll:Aamerig;
Cadd	Wàll:Réew;Wàll:Afrig;Wàll:Cadd;
Sili	Wàll:Aamerig;Wàll:Ciili| ;
Réewum Popileer bu Siin	Wàll:Réew;Wàll:Asi;Wàll:Siin;
Koloombi	Wàll:Réew;Wàll:Aamerig;Wàll:Koloombi;
Komoor	Wàll:Réew;Wàll:Afrig;Wàll:Komoor;
Kosta Riika	Wàll:Aamerig;Wàll:Réew;
Kodiwaar	Wàll:Réew;Wàll:Afrig;
Korwaasi	Wàll:Réew;Wàll:Tugal;Wàll:Korwaasi| ;
Kubaa	Wàll:Aamerig;Wàll:Réew;Wàll:Kubaa| ;
Ciipër	Wàll:Réew;Wàll:Tugal;Wàll:Dun;Wàll:Ciipër| ;
Finlaand	Wàll:Réew;Wàll:Tugal;Wàll:Finlaand;
Almaañ	Wàll:Almaañ| ;Wàll:Tugal;Wàll:Réew;
Jeoorji	Wàll:Jeoorji| ;Wàll:Réew;Wàll:Tugal;Wàll:Asi;
Gana	Wàll:Réew;Wàll:Afrig;Wàll:Gana;
Jibraltaar	Wàll:Nguur-Yu-Bennoo;Wàll:Tugal;
Girees	Wàll:Réew;Wàll:Tugal;Wàll:Girees| ;
Groenlaand	Wàll:Dun;Wàll:Danmaark;
Estooni	Wàll:Réew;Wàll:Tugal;Wàll:Estooni;
Salbadoor	Wàll:Réew;Wàll:Aamerig;Wàll:Salbadoor| ;
Ecoopi	Wàll:Réew;Wàll:Afrig;Wàll:Ecoopi;
Antigua ak Barbuda	Wàll:Réew;Wàll:Aamerig;Wàll:Antigua ak Barbuda;
Dunu Buwet	Wàll:Dun;Wàll:Noorwees;
Jibuti	Wàll:Réew;Wàll:Afrig;Wàll:Jibuti;
Dominika	Wàll:Réew;Wàll:Aamerig;
Ekwadoor	Wàll:Aamerig;Wàll:Réew;Wàll:Ekwadoor;
Isipt	Wàll:Afrig;Wàll:Asi;Wàll:Réew;Wàll:Isipt;
Gineg yamoo	Wàll:Réew;Wàll:Afrig;
Fiiji	Wàll:Oseyaani;Wàll:Réew;
Gaboŋ	Wàll:Réew;Wàll:Afrig;Wàll:Gaboŋ;
Onduras	Wàll:Réew;Wàll:Aamerig;Wàll:Onduras| ;
Guwaatemala	Wàll:Aamerig;Wàll:Réew;
Gine Bisaawóo	Wàll:Réew;Wàll:Afrig;
Guyaana	Wàll:Aamerig;Wàll:Réew;Wàll:Guyaana| ;
Ayiti	Wàll:Réew;Wàll:Aamerig;Wàll:Ayiti| ;
Ooŋ Koŋ	Wàll:Siin;
Ongiri	Wàll:Oonguri| ;Wàll:Réew;Wàll:Tugal;
Islaand	Wàll:Réew;Wàll:Tugal;Wàll:Dun;Wàll:Islaand| ;
Endoneesi	Wàll:Réew;Wàll:Asi;Wàll:Endoneesi;
Iraan	Wàll:Réew;Wàll:Asi;Wàll:Iraan;
Iraak	Wàll:Réew;Wàll:Asi;Wàll:Iraak;
Israayil	Wàll:Asi;Wàll:Réew;Wàll:Israayil;
Itaali	Wàll:Réew;Wàll:Tugal;Wàll:Itaali| ;
Jordaani	Wàll:Asi;Wàll:Réew;Wàll:Jordaani| ;
Kasakistaan	Wàll:Réew;Wàll:Tugal;Wàll:Asi;Wàll:Kasakistaan| ;
Keeñaa	Wàll:Réew;Wàll:Afrig;Wàll:Keeñaa;
Kiribati	Wàll:Réew;Wàll:Oseyaani;
Kowet	Wàll:Asi;Wàll:Réew;
Simbaawee	Wàll:Réew;Wàll:Afrig;Wàll:Simbaawee;
Saambi	Wàll:Réew;Wàll:Afrig;Wàll:Saambi;
Yaman	Wàll:Réew;Wàll:Asi;Wàll:Yaman;
Wiyetnaam	Wàll:Réew;Wàll:Wiyetnaam| ;
Benesuwela	Wàll:Réew;Wàll:Aamerig;Wàll:Benesuwela| ;
Wanuatu	Wàll:Réew;Wàll:Dun;Wàll:Oseyaani;
Usbekistaan	Wàll:Réew;Wàll:Asi;Wàll:Usbekistaan;
Uruguwaay	Wàll:Réew;Wàll:Aamerig;Wàll:Uruguwaay;
Ugandaa	Wàll:Réew;Wàll:Afrig;Wàll:Ugandaa;
Tirki	Wàll:Tirki| ;Wàll:Réew;Wàll:Tugal;Wàll:Asi;
Tiniisi	Wàll:Réew;Wàll:Afrig;Wàll:Tiniisi;
Tirinidaad ak Tobaago	Wàll:Réew;Wàll:Aamerig;
Tonga	Wàll:Tonga;Wàll:Réew;Wàll:Oseyaani;
Togóo	Wàll:Réew;Wàll:Afrig;Wàll:Togóo;
Taaylaand	Wàll:Réew;Wàll:Asi;
Tansani	Wàll:Réew;Wàll:Tansani;Wàll:Afrig;
Tajikistaan	Wàll:Réew;Wàll:Asi;
Filmi ci wollof	Wàll:Filmi ci Wolof;
Olaand	Wàll:Olaand;Wàll:Réew;Wàll:Tugal;
Suweed	Wàll:Réew;Wàll:Tugal;Wàll:Suweed| ;
Suwis	Wàll:Réew;Wàll:Tugal;Wàll:Suwis|*;
Kongóo-Brasaawiil	Wàll:Afrig;Wàll:Réew;
Kirgistaan	Wàll:Réew;Wàll:Asi;
Letóoni	Wàll:Réew;Wàll:Tugal;Wàll:Letóoni;
Libaa	Wàll:Réew;Wàll:Asi;
Lesoto	Wàll:Réew;Wàll:Afrig;Wàll:Lesoto;
Libeeria	Wàll:Réew;Wàll:Afrig;
Libi	Wàll:Réew;Wàll:Afrig;Wàll:Libi;
Liechtenstein	Wàll:Réew;Wàll:Tugal;
Lituwaani	Wàll:Réew;Wàll:Tugal;Wàll:Lituwaani| ;
Luksambuur	Wàll:Réew;Wàll:Tugal;
Makaaw	Wàll:Siin;
Réewum Maseduwaan	Wàll:Réew;Wàll:Tugal;Wàll:Réewum Maseduwaan;
Madagaskaar	Wàll:Réew;Wàll:Afrig;Wàll:Madagaskaar;
Malawi	Wàll:Afrig;Wàll:Réew;Wàll:Malawi;
Maldiif	Wàll:Asi;Wàll:Réew;Wàll:Maldiif;
Malt	Wàll:Réew;Wàll:Tugal;Wàll:Dun;Wàll:Malt;
Duni Marshall	Wàll:Réew;Wàll:Oseyaani;
Móoris	Wàll:Réew;Wàll:Afrig;
Meksik	Wàll:Réew;Wàll:Aamerig;Wàll:Meksik| ;
Moldaawi	Wàll:Réew;Wàll:Tugal;Wàll:Moldaawi|*;
Monaako	Wàll:Réew;Wàll:Tugal;Wàll:Monaako;
Mosambik	Wàll:Réew;Wàll:Afrig;
Miyanmaar	Wàll:Asi;Wàll:Réew;
Namibi	Wàll:Réew;Wàll:Afrig;Wàll:Namibi;
Nauru	Wàll:Oseyaani;Wàll:Réew;Wàll:Dun;Wàll:Nauru| ;
Nepaal	Wàll:Asi;Wàll:Réew;Wàll:Nepaal;
Nikaraaguwa	Wàll:Réew;Wàll:Aamerig;Wàll:Nikaraaguwa;
Niseer	Wàll:Réew;Wàll:Afrig;
Noorwees	Wàll:Noorwees;Wàll:Réew;Wàll:Tugal;
Omaan	Wàll:Asi;Wàll:Réew;Wàll:Omaan| ;
Pakistaan	Wàll:Réew;Wàll:Asi;
Palau	Wàll:Oseyaani;Wàll:Réew;
Palestiin	Wàll:Asi;
Panamaa	Wàll:Réew;Wàll:Aamerig;
Eslowaaki	Wàll:Réew;Wàll:Tugal;Wàll:Eslowaaki;
Araabi Sawdit	Wàll:Réew;Wàll:Asi;Wàll:Araabi Sawdit| ;
Ispaañ	Wàll:Réew;Wàll:Ispaañ;Wàll:Tugal;
Ruwandaa	Wàll:Réew;Wàll:Afrig;
Esloweeni	Wàll:Réew;Wàll:Tugal;Wàll:Esloweeni| ;
Somali	Wàll:Réew;Wàll:Afrig;
Kataar	Wàll:Réew;Wàll:Kataar;Wàll:Asi;
Tugal	Wàll:Tugal|*;Wàll:Gox yi;
Réewum Cek	Wàll:Réew;Wàll:Tugal;Wàll:Réewum Cek| ;
Poloñ	Wàll:Réew;Wàll:Tugal;Wàll:Poloñ| ;
Portugaal	Wàll:Réew;Wàll:Tugal;
San Marino	Wàll:Réew;Wàll:Tugal;
Nguur-Yu-Bennoo	Wàll:Réew;Wàll:Tugal;Wàll:Nguur-Yu-Bennoo;
Àdduna	Wàll:Melosuuf;Wàll:Suuf;
Afrig	Wàll:Afrig;
Afrig gu Bëj-saalum	Wàll:Afrig;Wàll:Réew;Wàll:Afrig gu Bëj-saalum| ;
Asi	Wàll:Asi|*;Wàll:Gox yi;Wàll:Adduna;Wàll:Melosuuf;Wàll:Bereb yi ci Téere Linjiil;
Aamerig	Wàll:Adduna;Wàll:Melosuuf;Wàll:Aamerig;
Paraguwaay	Wàll:Réew;Wàll:Aamerig;Wàll:Paraguwaay;
Peru	Wàll:Réew;Wàll:Aamerig;Wàll:Peru| ;
Biibël	Wàll:Diine;
Yéesu-kristaa	Wàll:Diine;
Nowel	Wàll:Diine;
Samowaa	Wàll:Oseyaani;Wàll:Réew;
Filipiin	Wàll:Asi;Wàll:Réew;Wàll:Filipiin;
Sudaan	Wàll:Réew;Wàll:Afrig;
Saw Tome ak Preesip	Wàll:Réew;Wàll:Afrig;Wàll:Sao Tome ak Principe;
Siraa Leyoon	Wàll:Réew;Wàll:Afrig;
Seysel	Wàll:Réew;Wàll:Afrig;
Singapoor	Wàll:Réew;Wàll:Asi;
Suwaasilaand	Wàll:Réew;Wàll:Afrig;Wàll:Suwaasilaand;
Surinaam	Wàll:Réew;Wàll:Aamerig;
Siri Laanka	Wàll:Réew;Wàll:Asi;
Duni Virgin (angalteer)	Wàll:Nguur-Yu-Bennoo;
Duni Virgin (us)	Wàll:Diwaan-yu-bennoo;
Taaywaan	Wàll:Asi;Wàll:Réew;
Kore gu Bëj-gànnaar	Wàll:Asi;Wàll:Réew;
Ousmane Sembène	Wàll:Sinemaa;
Ndar	Wàll:Dëkki Senegaal;
Martinik	Wàll:Faraas;Wàll:Dun;
Riisi	Wàll:Riisi;Wàll:Tugal;Wàll:Asi;Wàll:Réew;
Sapoŋ	Wàll:Réew;Wàll:Asi;Wàll:Sapoŋ;
Jamayka	Wàll:Réew;Wàll:Dun;Wàll:Aamerig;Wàll:Jamayka| ;
Irlaand	Wàll:Réew;Wàll:Dun;Wàll:Tugal;Wàll:Irlaand| ;
Watikaa	Wàll:Réew;Wàll:Tugal;
Maleesi	Wàll:Réew;Wàll:Asi;Wàll:Maleesi| ;
Diiwaan yu Bennoo	Wàll:Réew;Wàll:Aamerig;Wàll:Diwaan-yu-bennoo| ;
Eritere	Wàll:Réew;Wàll:Afrig;Wàll:Eritere;
Dunu Christmas	Wàll:Dun;
Dunu Kokos	Wàll:Dun;
Guwaadalup	Wàll:Dun;Wàll:Faraas;
Guyaana gu Faraas	Wàll:Faraas;
Grenada	Wàll:Réew;Wàll:Dun;Wàll:Aamerig;
United States Minor Outlying Islands	Wàll:Dun;
Royuwaay:Commons	Royuwaay|Commons;
Royuwaay:Junj	Junj;Wàll:Royuwaay;
Wikipedia:Tàmbali	Wàll:Barab Wikipedia;
Guam	Wàll:Dun;
Kongóo-Kinshasa	Wàll:Réew;Wàll:Afrig;Wàll:Kongóo-Kinshasa;
Mongoli	Wàll:Asi;Wàll:Réew;Wàll:Mongoli| ;
Kore gu Bëj-saalum	Wàll:Réew;Wàll:Asi;Wàll:Kore gu Bëj-saalum;
Romaani	Wàll:Réew;Wàll:Tugal;Wàll:Romaani| ;
Seerbi	Wàll:Réew;Wàll:Tugal;
Ukreen	Wàll:Réew;Wàll:Tugal;Wàll:Ukreen;
Pari	Wàll:Faraas;Wàll:Péy;
Bunt:Melosuuf	Wàll:Bunt|Melosuuf;Wàll:Melosuuf;
Réew	Wàll:Réew| ;
Dùn	Wàll:Nguur-Yu-Bennoo;Wàll:Dun;
Djibril Dio Mambéty	Wàll:Senegaal;Wàll:Sinemaa;
Géej	Wàll:Géej;
Bunt:Diine	Wàll:Diine|*;Wàll:Bunt|Diine;
Banjul	Wàll:Péy;Wàll:Afrig;Wàll:Gàmbi;
Mexe	Wàll:Dëkki Senegaal;
Turkumenistaan	Wàll:Réew;Wàll:Asi;
Dunu Kook	Wàll:Réew;Wàll:Dun;
Mbàmbulaan Gu-Dal	Wàll:Mbàmbulaan yi;
Heard Island and McDonald Islands	Wàll::Dun;
Duni Faarow	Wàll:Dun;Wàll:Nguur-Yu-Bennoo;
Duni Kaymaan	Wàll:Dun;
Wikipedia:Buntuw Askan wi	commons:Licensing templates|hundreds templates;c:Wikipedia15 Mark|list of all the Wikipedia 15 logos;c:Wikipedia15 Mark|list of all the Wikipedia 15 logos;
Kaledooni-Gu-Bees	Wàll:Dun;Wàll:Faraas;
Poortorikoo	Wàll:Poortorikoo;
Seland-Gu-Bees	Wàll:Réew;Wàll:Dun;
Réewum Dominik	Wàll:Réew;Wàll:Dun;Wàll:Aamerig;
Mbàmbulaanug Atlas	Wàll:Mbàmbulaan yi;
Tuvalu	Wàll:Réew;Wàll:Dun;
Seent Eleen	Wàll:Dun;Wàll:Nguur-Yu-Bennoo;
Mayoot	Wàll:Dun;Wàll:Faraas;
Montserrat	Wàll:Aamerig;Wàll:Dun;
Sahara gu Sowwu	Wàll:Afrig;Wàll:Réew;
Réewum Diggu Afrig	Wàll:Réew;Wàll:Afrig;
Tokelau	Wàll:Dun;
Mbàmbulaanug End	Wàll:Mbàmbulaan yi;
Duni Solomon	Wàll:Réew;Wàll:Dun;
Dunu Falkland	Wàll:Dun;Wàll:Nguur-Yu-Bennoo;
Dunu Norfolk	Wàll:Dun;
Saint Lucia	Wàll:Réew;Wàll:Dun;Wàll:Aamerig;
Réewum Lawos	Wàll:Réew;Wàll:Asi;
Pitkeern	Wàll:Dun;Wàll:Nguur-Yu-Bennoo;
Saint Kitts and Nevis	Wàll:Réew;Wàll:Dun;Wàll:Aamerig;
Papuwaasi-Gine-Gu-Bees	Wàll:Réew;Wàll:Dun;
Saint Pierre ak Miquelon	Wàll:Dun;Wàll:Faraas;
Wallis ak Futuna	Wàll:Dun;Wàll:Wallis ak Futuna;Wàll:Faraas;
Turks and Caicos Islands	Wàll:Dun;
Swalbard ak Jan Mayen	Noorwees;
Polineesi gu Faraas	Wàll:Faraas;Wàll:Dun;
Reiñõo	Wàll:Dun;Wàll:Faraas;
Siri	Wàll:Réew;Wàll:Asi;Wàll:Siri;
Saint Vincent and the Grenadines	Wàll:Dun;Wàll:Aamerig;Wàll:Réew;
Imaaraat yu Araab yu Bennoo yi	Wàll:Réew;Wàll:Asi;Wàll:Imaarati Araab yu Bennoo| ;
Jeoorji gu Bëj-saalum ak Duni Islaand yi Bëj-saalum	Wàll:Dun;Wàll:Nguur-Yu-Bennoo;
Cees	Wàll:Dëkki Senegaal;
Jurbel	Wàll:Dëkki Senegaal;
Mbuur	Wàll:Dëkki Senegaal;
Luga	Wàll:Dëkki Senegaal;
Podoor	Wàll:Dëkki Senegaal;
Tëngéej	Wàll:Dëkki Senegaal;
Tuubaa	Wàll:Dëkki Senegaal;Wàll:Yoonu murit;
Xaralay xibaar ak jokkoo	Wàll:Xam-xamu nosukaay;
Dex	Wàll:Melosuuf;Wàll:Ndox;
Kàllaama	Wàll:Làkk;
Nataal	Wàll:Xarala;Wàll:Fànn;
Maatam	Wàll:Dëkki Senegaal;
Way	Wàll:Woy;
Xayma	Wàll:Xayma|*;Wàll:Bunt|Xayma;
Cuub	Wàll:Cuub;
Taariix	Wàll:Taariix|*;
Yatt	Wàll:Fànn;
Beer	Wàll:Dun;Wàll:Senegaal;
Soxna	Wàll:Lislaam;
Royuwaay:Jëfandikukat	Wàll:Royuwaay;
Wikipédia:Yorkat/Woloflover	Wàll:Yorkat;
Ayóoba	Wàll:Diine;Wàll:Yonenti Lislaam;
Cosaan	Wàll:Cosaan;Wàll:Séeréer;
Yuusu Nduur	Wàll:Woy;Wàll:Nit;
Aadama	Wàll:Diine;Wàll:Yonenti Lislaam;
1 Musaa	Wàll:Diine;
Aana	Wàll:Nit ñi ci Kàddug Yàlla;Wàll:Nit ñi ci Linjiil;
Aaroona	Wàll:Diine;Wàll:Yonenti Lislaam;Wàll:Diine;Wàll:Yonenti Lislaam;Wàll:Nit ñi ci Téere Tawreet;
Abadon	Wàll:Baat yi jóge làkku ibrë;
Abba	Wàll:Baat yi jóge làkku yawut;
Abel	Wàll:Nit ñi ci Kàddug Yàlla;Wàll:Nit ñi ci Téere Tawreet;
Abilen	Wàll:Bereb yi ci Téere Linjiil;Wàll:Siri;
Abiya	Wàll:Nit ñi ci Kàddug Yàlla;
Abiyatar	Wàll:Nit ñi ci Kàddug Yàlla;
Abiyudd	Wàll:Nit ñi ci Kàddug Yàlla;
Adaramit	Wàll:Bereb yi ci Téere Linjiil;Wàll:Tirki;
Adi	Wàll:Nit ñi ci Kàddug Yàlla;
Adiratig	Wàll:Bereb yi ci Téere Linjiil;Wàll:Itaali;
Admin	Wàll:Nit ñi ci Kàddug Yàlla;
Aram	Wàll:Nit ñi ci Kàddug Yàlla;
Afiya	Wàll:Nit ñi ci Téere Linjiil;
Agabus	Wàll:Nit ñi ci Kàddug Yàlla;Wàll:Nit ñi ci Téere Linjiil;
Agaripa	Wàll:Nit ñi ci Kàddug Yàlla;Wàll:Nit ñi ci Téere Linjiil;
Ajara	Wàll:Nit ñi ci Kàddug Yàlla;Wàll:Nit ñi ci Téere Tawreet;
Akas	Wàll:Nit ñi ci Kàddug Yàlla;
Akayi	Wàll:Bereb yi ci Téere Linjiil;Wàll:Girees;
Akaykus	Wàll:Nit ñi ci Kàddug Yàlla;Wàll:Nit ñi ci Téere Linjiil;
Akilas	Wàll:Nit ñi ci Kàddug Yàlla;Wàll:Nit ñi ci Téere Linjiil;
Akim	Wàll:Nit ñi ci Kàddug Yàlla;
Albaatar	Wàll:Per yi ak Xeer yi ci Kàddug Yàlla;
Alegsàndar	Wàll:Nit ñi ci Kàddug Yàlla;Wàll:Nit ñi ci Téere Linjiil;
Alegsàndiri	Wàll:Bereb yi ci Téere Linjiil;Wàll:Isipt;
Alfe	Wàll:Nit ñi ci Kàddug Yàlla;Wàll:Nit ñi ci Téere Linjiil;
Alisa	Wàll:Diine;Wàll:Yonenti Lislaam;
Almasi bi	Wàll:Baat yi jóge làkku ibrë;
Aloos	Wàll:Gàncax yi ak garab yi ci Kàddug Yàlla;
Ametist	Wàll:Per yi ak Xeer yi ci Kàddug Yàlla;
Royuwaay:PD-self	Wàll:Dencukaay;Wàll:Dencukaay;Wàll:Royuwaay|PD-self;
Amfipolis	Wàll:Bereb yi ci Téere Linjiil;
Aminadab	Wàll:Nit ñi ci Kàddug Yàlla;Wàll:Nit ñi ci Téere Tawreet;
Amiin	Wàll:Baat yi jóge làkku ibrë;
Amon	Wàll:Nit ñi ci Kàddug Yàlla;
Amos	Wàll:Nit ñi ci Kàddug Yàlla;Wàll:Nit ñi ci Téere Linjiil;
Ampilyaatus	Wàll:Nit ñi ci Kàddug Yàlla;Wàll:Nit ñi ci Téere Linjiil;
Anañas	Wàll:Nit ñi ci Kàddug Yàlla;Wàll:Nit ñi ci Téere Linjiil;
Anas	Wàll:Nit ñi ci Kàddug Yàlla;Wàll:Nit ñi ci Téere Linjiil;
Ancos ci Siri	Wàll:Bereb yi ci Téere Linjiil;Wàll:Siri;
Ancos ci Pisidi	Wàll:Bereb yi ci Téere Linjiil;Wàll:Tirki;
Barnabas	Wàll:Nit ñi ci Téere Linjiil;
Andare	Wàll:Nit ñi ci Kàddug Yàlla;Wàll:Nit ñi ci Téere Linjiil;
Andoronikus	Wàll:Nit ñi ci Kàddug Yàlla;Wàll:Nit ñi ci Téere Linjiil;
Anet	Wàll:Gàncax yi ak garab yi ci Kàddug Yàlla;
Antipas	Wàll:Nit ñi ci Kàddug Yàlla;Wàll:Nit ñi ci Téere Linjiil;
Antipataris	Wàll:Bereb yi ci Téere Linjiil;
Apeles	Wàll:Nit ñi ci Kàddug Yàlla;Wàll:Nit ñi ci Téere Linjiil;
Apiyus, péncu	Wàll:Bereb yi ci Téere Linjiil;
Apoloni	Wàll:Bereb yi ci Téere Linjiil;Wàll:Girees;
Apolos	Wàll:Nit ñi ci Kàddug Yàlla;Wàll:Nit ñi ci Téere Linjiil;
Apolyon	Wàll:Leeral Biibël;
Araab	Wàll:Xeet yi;
Arabi	Wàll:Bereb yi ci Téere Linjiil;
Aretas	Wàll:Nit ñi ci Kàddug Yàlla;Wàll:Nit ñi ci Téere Linjiil;
Areyopas	Wàll:Bereb yi ci Téere Linjiil;Wàll:Girees;
Arimate	Wàll:Bereb yi ci Téere Linjiil;
Aristàrk	Wàll:Nit ñi ci Kàddug Yàlla;Wàll:Nit ñi ci Téere Linjiil;
Aristobul	Wàll:Nit ñi ci Kàddug Yàlla;Wàll:Nit ñi ci Téere Linjiil;
Arkelawus	Wàll:Nit ñi ci Kàddug Yàlla;Wàll:Nit ñi ci Téere Linjiil;
Arkib	Wàll:Nit ñi ci Kàddug Yàlla;Wàll:Nit ñi ci Téere Linjiil;
Armagedon	Wàll:Bereb yi ci Téere Linjiil;
Arpagsàdd	Wàll:Nit ñi ci Kàddug Yàlla;Wàll:Nit ñi ci Téere Tawreet;
Artemas	Wàll:Nit ñi ci Kàddug Yàlla;Wàll:Nit ñi ci Téere Linjiil;
Artemis	Wàll:Yàllay xeet yi;
Asaf	Wàll:Nit ñi ci Kàddug Yàlla;
Asànkirit	Wàll:Nit ñi ci Kàddug Yàlla;Wàll:Nit ñi ci Téere Linjiil;
Aser	Wàll:Nit ñi ci Téere Linjiil;
Asor	Wàll:Nit ñi ci Kàddug Yàlla;Wàll:Nit ñi ci Téere Linjiil;
Asos	Wàll:Bereb yi ci Téere Linjiil;Wàll:Tirki;
Asot	Wàll:Bereb yi ci Téere Linjiil;
Atali	Wàll:Bereb yi ci Téere Linjiil;Wàll:Tirki;
Aten	Wàll:Bereb yi ci Téere Linjiil;Wàll:Girees;Wàll:Péy;
Awa	Wàll:Nit ñi ci Kàddug Yàlla;Wàll:Nit ñi ci Téere Tawreet;
Aynon	Wàll:Bereb yi ci Téere Linjiil;
Alxuraan	Wàll:Lislaam;
Wolof (làkk)	commons:Wolof pronunciation| commons:Wolof pronunciation;Wàll:Wolof;Wàll:Làkki senegaal;Wàll:Làkk;
Ahmadou Bamba	Wàll:Niti senegaal;
Baal	Wàll:Yàllay xeet yi;
Babilon	Wàll:Bereb yi ci Téere Linjiil;
Balaam	Wàll:Nit ñi ci Kàddug Yàlla;Wàll:Nit ñi ci Téere Tawreet;
Balag	Wàll:Nit ñi ci Kàddug Yàlla;Wàll:Nit ñi ci Téere Tawreet;
Balastus	Wàll:Nit ñi ci Kàddug Yàlla;Wàll:Nit ñi ci Téere Linjiil;
Elimas	Wàll:Nit ñi ci Kàddug Yàlla;Wàll:Nit ñi ci Téere Linjiil;
Barabas	Wàll:Nit ñi ci Kàddug Yàlla;Wàll:Nit ñi ci Téere Linjiil;
Barsabas	Wàll:Nit ñi ci Kàddug Yàlla;Wàll:Nit ñi ci Téere Linjiil;
Bartelemi	Wàll:Nit ñi ci Kàddug Yàlla;Wàll:Nit ñi ci Téere Linjiil;
Bartime	Wàll:Nit ñi ci Kàddug Yàlla;Wàll:Nit ñi ci Téere Linjiil;
Royuwaay:Babel	:Wàll:Waa-wikipedia ci làkk-ak-làkk|Seet waa-wikipedia ci làkk-ak-làkk;Wàll:Boyutu Babel| ;
Barag	Wàll:Nit ñi ci Kàddug Yàlla;
Baraki	Wàll:Nit ñi ci Kàddug Yàlla;
Beelsebul	Wàll:Yàllay xeet yi;
Beliyar	Wàll:Yàllay xeet yi;
Ben-yamin	Wàll:Nit ñi ci Kàddug Yàlla;Wàll:Nit ñi ci Téere Tawreet;Wàll:Nit ñi ci Kàddug Yàlla;Wàll:Nit ñi ci Téere Tawreet;
Bere	Wàll:Bereb yi ci Téere Linjiil;
Berenis	Wàll:Nit ñi ci Kàddug Yàlla;Wàll:Nit ñi ci Téere Linjiil;
Beril	Wàll:Per yi ak Xeer yi ci Kàddug Yàlla;
Betani	Wàll:Bereb yi ci Téere Linjiil;
Betani bu Yerusalem	Wàll:Bereb yi ci Téere Linjiil;
Betani bu Yurdan	Wàll:Bereb yi ci Téere Linjiil;
Betesda	Wàll:Bereb yi ci Téere Linjiil;
Betfase	Wàll:Bereb yi ci Téere Linjiil;
Betleyem	Wàll:Bereb yi ci Téere Linjiil;
Betsayda	Wàll:Bereb yi ci Téere Linjiil;
Bitini	Wàll:Bereb yi ci Téere Linjiil;Wàll:Tirki;
Bosor	Wàll:Nit ñi ci Kàddug Yàlla;
Bowanerses	Wàll:Baat yi jóge làkku yawut;
Bowas	Wàll:Nit ñi ci Kàddug Yàlla;Wàll:Nit ñi ci Téere Linjiil;
Bànni Israyil	Wàll:Leeral Biibël;
Catir	Wàll:Bereb yi ci Téere Linjiil;Wàll:Tirki;
Daawuda	Wàll:Diine;Wàll:Yonenti Lislaam;
Dalmanuta	Wàll:Bereb yi ci Téere Linjiil;
Dalmasi	Wàll:Bereb yi ci Téere Linjiil;Wàll:Tugal;Wàll:Dalmasi;
Damaris	Wàll:Nit ñi ci Kàddug Yàlla;Wàll:Nit ñi ci Téere Linjiil;
Bunt: Xarala	Wàll:Bunt|Xarala;Wàll:Xarala|*;
Xam-xam	Wàll:Xam-xam;
Xam-xami nite ak mboolaay	Wàll:Xam-xam;
Njàngat	Wàll:Njàngat;
Xaralaymbëj	Wàll:Xaralaymbëj|xaralaymbëj;
Mbëj	Wàll:Mbëj;
Wikipedia:Xët wu njëkk	Wàll:Barab Wikipedia|{{PAGENAME}};
Doxalukaay bu mbëj	Wàll:Wuutuloxo yu mbëj;
Xam-xamu suuf si ak jawwu ji	Wàll:Xam-xam;Wàll:Suuf;
Pac	Wàll:Xam-xam;
Royuwaay:Noppi	Wàll:Royuwaay|{{PAGENAME}};
Royuwaay:Diinelislaam	:Wàll:Yonenti Lislaam| Yonenti lislaam;Wàll:Royuwaay diine;
Sëriñ Muusaa KA	Wàll:Niti senegaal;Wàll:Yoonu murit;
Téere Taariix	Wàll:Taariix;
Mamoor Xam Sa Diine	Wàll:Mamoor Xam Sa Diine| ;Wàll:Yoonu murit;
Dalub Archimède	Wàll:Jëmm;
Diisaayu yaram yi	Wàll:Xam-xam;
Simi	Wàll:Simi|Simi;
Sawara	Wàll:Jëmm;Wàll:Simi;
Rab	Wàll:Rab| ;
Gàncax	Wàll:Gàncax| ;
Xeet	Wàll:Simi;
Ngelaw	Wàll:Simi;
Ne-ne	Wàll:Ne-ne| ;Wàll:Jëmm;Wàll:Simi;
Liggéeyiinu mbell	Wàll:Jëmm;Wàll:Xarala;Wàll:Endustri;
Yolaakon	Wàll:Simi;Wàll:Jëmm;
Junj	Wàll:xam-xam;Wàll:Njàngat;
Jum	Wàll:Xarala;
Dooley ñoddi	Wàll:Jëmm;
Kattanug përëg	Wàll:paj;
Kol-kolu suuf si	Wàll:Suuf;
Jawwu ji	Wàll:Xam-xam;Wàll:Melosuuf;
Fatt-jawwu	Wàll:Jëmm;Wàll:Suuf;
Yolom-jawwu	Wàll:Suuf;
Biti-jawwu	Wàll:Suuf;
Ag féex gu joyoo	Wàll:Xam-xamu suuf si ak jawwu ji;
Dalu Archimède	Wàll:Doolerandu;
Ndimbal:Caytu	Jagleel:Catégories|Wàll;Wàll:Ndimbal;
Paj	Wàll:Xam-xam;Wàll:Paj;
Doolerandu	Wàll:Doolerandu;
Jokkoo-cig-soree	Wàll:Xarala;
Kàttan	Wàll:Jëmm;Wàll:Kàttan;
Yoon	Wàll:Yoon| ;
Koom-koom	Wàll:Koom-koom;
Wikipedia	Wàll:Sémbi Wikimedia Fondation;Wàll:Jimbulang;
Mohammed	Wàll:Diine;Wàll:Yonenti Lislaam;Wàll:Lislaam;
Xeltu	Wàll:Xeltu;
Wuutuloxo	Wàll:Doolerandu;Wàll:Xarala;
Yëglu cig sori	Wàll;
Nekk	Wàll:Jëmm;
Berlin	Wàll:Péy;Wàll:Almaañ;
Royuwaay:Diineyyëwut	Wàll:Royuwaay diine;
Royuwaay:Wikibaatukaay	Wàll:Royuwaay;w:{{#if:{{{lang|}}}|{{{lang}}}:}}{{ucfirst:{{{cat|{{{category}}}}}}}}|{{ucfirst:{{{1|{{{cat|{{{category}}}}}}}}}}};w:{{#if:{{{lang|}}}|{{{lang}}}:}}{{ucfirst:{{{mulcat}}}}}|{{ucfirst:{{{mulcatlabel|{{{mulcat}}}}}}}};
Royuwaay:Melosuuf/bunt	Wàll:Royuwaay séwógaraafi;
Royuwaay:Sewogaraafi/suufsi	Wàll:Royuwaay séwógaraafi;
Royuwaay:Ciyoonudefaru	Wàll:Royuwaay;
Melosuuf	Wàll:Melosuuf;
Muriidulaa	Wàll:Yoonu murit;
Royuwaay:Suuf si	Wàll:Royuwaay séwógaraafi;
Téere Irwaun Nadiim ci Sëriñ Tuubaa	Wàll:Yoonu murit;
Téere Tasawudus sixaar	Wàll:Yoonu murit;
Liggéey (ci muridulaa)	Wàll:Yoonu murit;
Royuwaay:Limureewiafrik	Wàll:Royuwaay séwógaraafi mu réew;
Jëmm	Wàll:Xam-xam;Wàll:Jëmm;
Kawaarig	Wàll:Xam-xam;
Royuwaay:Taariix	Wàll:Royuwaay;
Royuwaay:Yagg	Wàll:Royuwaay;
Royuwaay:Diggu	Wàll:Royuwaay;
Royuwaay:Yees	Wàll:Royuwaay;
Bunt: taariix	Wàll:Taariix| ;
Yewwute	Wàll:Taariix;
Jolof	Wàll:Taariixu senegaal;Wàll:Nguuri senegaal;
Royuwaay:Buntutaariix	Wàll:Royuwaay;
Alburi Njaay	Wàll:niti senegaal;
Waalo	Wàll:Taariixu senegaal;Wàll:Afrig;Wàll:senegaal;Wàll:nguuri senegaal;
Kajoor	Wàll:Taariixu senegaal;Wàll:Afrig;Wàll:senegaal;Wàll:nguuri senegaal;
Royuwaay:Xët wu njëkk/ubbite	Wàll:Xët wu njëkk|U;
Leeral Biibël	:Wàll:Nit ñi ci Kàddug Yàlla;:Wàll:Nit ñi ci Téere Tawreet;:Wàll:Nit ñi ci Téere Linjiil;:Wàll:Bereb yi ci Téere Linjiil;:Wàll:Baat yi jóge làkku ibrë;:Wàll:Baat yi jóge làkku yawut;:Wàll:Baat yi jóge làkku gereg;:Wàll:Per yi ak Xeer yi ci Kàddug Yàlla;:Wàll:Mala yi ci Kàddug Yàlla;:Wàll:Gàncax yi ak garab yi ci Kàddug Yàlla;:Wàll:Xeet yi;:Wàll:Yàllay xeet yi;:Wàll:Njàngalem Mbooloom Kirist yi am solo;Wàll:Leeral Biibël|*;
Ndimbal:Dalal-jàmm	Wàll:Jeego yu njëkk;
Royuwaay:Yëgle	Wàll:Royuwaay;
Royuwaay:Luyxew	Wàll:Royuwaay;
Royuwaay:Gan ñi	Wàll:Xët wu njëkk;
Royuwaay:Buntaskan	Wàll:Royuwaay;
Royuwaay:Diwaaniafrik	Wàll:Royuwaay séwógaraafi;
Diggu Afrig	Wàll:Diwaani Afrig;
Imbraatóor gu Mali	Wàll:Taariixu Afrig;Wàll:Nguuri Afrig;
Siin-Saalum	Wàll:Taariixu senegaal;Wàll:Afrig;Wàll:nguuri senegaal;Wàll:Cosaan Séeréer;Wàll:Taariixu Gàmbi;
Royuwaay:Yeneenlàkk	Wàll:Xët wu njëkk|Y;
Royuwaay:Xët wu njëkk/limuwaay ndeyjoor	Wàll:Xët wu njëkk|L;
Sowwu Afrig	Wàll:Melosuuf;Wàll:Afrig;Wàll:Diwaani Afrig;
Bëj-gànnaaru Afrig	Wàll:Diwaani Afrig;
Bëj-saalumu Afrig	Wàll:Melosuuf;Wàll:Afrig;Wàll:Diwaani Afrig;
Penku Afrig	Wàll:Diwaani Afrig;
Royuwaay:Gox	Wàll:Royuwaay séwógaraafi;
Gox	Wàll:Gox yi;
Afrig gu bëj-saalumu-Sahara	Wàll:Melosuuf;Wàll:Afrig;Wàll:Diwaani Afrig;
Sahel	Wàll:Diwaani Afrig;
Bejjenu Afrig	Wàll:Melosuuf;Wàll:Afrig;Wàll:Diwaani Afrig;
Maghreb	Wàll:Melosuuf;Wàll:Diwaani Afrig;
Isipt gu yàgg ga	Wàll:Isipt gu yàgg ga;Wàll:Taariixu Isipt;
Lislaam ci sowu Afrik	Wàll:Lislaam;
Imbraatóor gu Gana	Wàll:Taariixu Afrig;Wàll:Nguuri Afrig;
Imbraatóor gu Songaay	Wàll:Taariixu Afrig;Wàll:Nguuri Afrig;
Njàppum jaam	Wàll:Taariix|*;
Ñëwug waa-tugal ci Afrik	Wàll:Taariixu Afrig;Wàll:Melosuuf;
Sëriñ Tuubaa	Wàll:niti senegaal;Wàll:Yoonu murit;
Sudaan (diiwaan)	Wàll:Melosuuf;Wàll:Afrig;Wàll:Diwaani Afrig;
Melosuufug Tugal	Wàll:Tugal;Wàll:Melosuuf;
Royuwaay:Diwaani amerik	Wàll:Royuwaay séwógaraafi;
Diggu Aamerig	Wàll:Diwaani Aamerig;
Melosuufug Afrig	Wàll:Melosuufug afrig| ;
Afritugalasi	Wàll:Gox yi;
Tugalasi	Wàll:Gox yi;
Oseyaani	Wàll:Gox yi;
Royuwaay:Réewi oseyaani	Wàll:Royuwaay séwógaraafi mu réew;
Royuwaay:Réewi Bëj-saalumu Aamerik	Wàll:Royuwaay séwógaraafi mu réew;
Bëj-saalumu Aamerig	Wàll:Gox yi;Wàll:Aamerig;Wàll:Diwaani Aamerig;
Bëj-gànnaaru Aamerig	Wàll:Gox yi;Wàll:Aamerig;Wàll:Diwaani Aamerig;
Royuwaay:Réewi Bëj-gànnaaru Aamerik	Wàll:Royuwaay séwógaraafi mu réew;
Xaaju kol-kol	Wàll:Falag;
Royuwaay:Réewi afrig	Réew|*;
Diggu Asi	Wàll:Asi;
Diiwaan	Wàll:Diiwaan| ;
Penku Asi	Wàll:Asi;
Bëj-saalum-penku Asi	Wàll:Asi;
Ron-goxu End	Wàll:Asi;
Penku gu Sori	Wàll:Asi;
Penku gu Diggu	Wàll:Asi;
Penku gu Jege	Wàll:Asi;
Bëj-gànnaaru Tugal	Wàll:Melosuufug Tugal;
Penku Tugal	Wàll:Melosuufug Tugal;
Bëj-saalumu Tugal	Wàll:Melosuufug Tugal;
Ponki Lislaam	Wàll:Lislaam;
Koor	Wàll:Ponki Lislaam;Wàll:Lislaam;
Xam-xamu nosukaay	Wàll:Xam-xamu nosukaay;
Nosukaay	Wàll:Xam-xamu nosukaay;
Mbëjfeppal	Wàll:Mbëjfeppal;
Géej gu Diggu	Wàll:Géej;Wàll:Diiwaani Tugal;
Seere	Wàll:Lislaam;Wàll:Ponki Lislaam;
Gëm Yàlla	Wàll:Lislaam;
Gëm Malaaka yi	Wàll:Lislaam;
Gëm Téere yi	Wàll:Lislaam;
Gëm Yonnant yi	Wàll:Lislaam;
Gëm Bis Pénc	Wàll:Lislaam;
Gëm Dogal bi	Wàll:Lislaam;
Julli	Wàll:Lislaam;Wàll:Ponki Lislaam;
Laab	Wàll:Diine;Wàll:Lislaam;
Natt asaka	Wàll:Ponki Lislaam;Wàll:Lislaam;
Farata ak sunnaay asaka	Wàll:Ponki Lislaam;
Aj Màkka	Wàll:Lislaam;Wàll:Ponki Lislaam;
Faratay aj	Wàll:Ponki Lislaam;
Sunnaay aj	Wàll:Ponki Lislaam;
Xay	Wàll:Xay;
Sowwu Tugal	Wàll:Melosuufug Tugal;
Lonkoyoon	Wàll:Melosuuf;
Curitiba	Wàll:Dëkk;Wàll:Breesil;
Taariixu Senegaal	Wàll:Taariixu senegaal|*;
Alaaji Omar Fuutiyu TAAL	Wàll:niti senegaal;
Melaneesi	Wàll:Diwaani oseyaani;
Mikroneesi	Wàll:Diwaani oseyaani;
Polineesi	Wàll:Diwaani oseyaani;
Mbàmbulaan	Wàll:Mbàmbulaan yi| ;
Tus-wu-gaar	Wàll:Melosuuf;
Dottub Bëj-saalum	Wàll:Diiwaani dott;
Diiwaani dott	Wàll:diiwaani dott;
Fuuta Tooro	Wàll:nguuri senegaal;
Bawol	Wàll:nguuri senegaal;Wàll:Taariixu senegaal;Wàll:Cosaan Séeréer;
Kaw Gaambi ak Penku Senegaal	Wàll:nguuri senegaal;Wàll:Taariixu senegaal;
Kaasamaas	Wàll:Nguuri senegaal;Wàll:Taariixu senegaal;
Nguuri Pël yi	Wàll:nguuri senegaal;
Lat Joor	Wàll:niti senegaal;
Alaaji Omar Taal	Wàll: niti senegaal;
Muhammad Lamin Daraame	Wàll:niti senegaal;
Saamóori Ture	Wàll:Niti senegaal;
Seydinaa Limaamu Laay	Wàll:niti senegaal;
Aliin Situwe Jaata	Wàll:niti senegaal;
Ndajem Berlin	Wàll:cancug afrik;
Ñaareelu Xareb Àdduna	Wàll:Xarey àdduna;
Lenn ci taariix	Wàll yi xam-xam jëme kanam ci Tugal;Wàll:Taariix;
Wuññi yu melosuuf yi	Wàll:Melosuuf;
Yëngu-yëngu yi jugoon di safaan Jàngu bu Paab bi	Wàll:taariix;
Jëm kanam gu xam-xam	Wàll:xam-xam;Wàll:Endustri;
Yewwute gu ndefar	Wàll:Endustri;
Taariixu Aamerig	Wàll:Politig;Wàll:Taariixu Aamerig;
Jeqiku ga amoon ca Faraas	Wàll:Taariixu Tugal;
Taariixu Itaali	Wàll:Taariix;Wàll:Itaali;
Sancug waa Tugal ci Afrig	Wàll:Koom-koom;
Mbootaay yu àdduna yi	Wàll:Adduna;
Ni Sapoŋ jëme kanam	Wàll:Sapoŋ;
Royuwaay:Nataalu ayubés bi	Wàll:Xët wu njëkk|N;
Léebu	Wàll:Làkk;
Arminaat	Wàll:Arminaat| ;
Saytubiddiw	Wàll:Saytubiddiw| ;
Gëstubiddiw	Wàll:Gëstubiddiw;
Koom-koomu Afrig	Wàll:Koom-koomu Afrig;
Melosuufug Afrig gu Bëj-saalum	Wàll:Melosuufug Afrig gu Bëj-saalum;Wàll:Melosuufug afrig;
Melosuufug Alseeri	Wàll:Melosuufug afrig;Wàll:Melosuufug Alseeri;
Seex Anta Jóob	Wàll:niti senegaal;
Mbàmbulaan gu Bëj-saalum	Wàll:Mbàmbulaan yi;
Mbàmbulaan gu Bëj-gànnaar	Wàll:Mbàmbulaan yi;
Dottub Bëj-gànnaar	Wàll:Diiwaani dott;
Końskowola	Wàll:Poloñ;
Kureelu Mbootayu Xeet yi	Wàll:Kureelu Mbootayu Xeet yi;Wàll:Adduna;
Mbootaayu Réewi Jullit yi	Wàll:Lislaam;
Way dëkki Afrig	Wàll:Afrig;
Leopool Sedaar Sengoor	Wàll:niti senegaal;Wàll:njiiti Senegaal;
Xamale kuy Sëriñ bi, ak ay mbiram, ba bi waajuram wu góor làqoo	Wàll:Dundug Seex Ahmadu Bamba;
Ginaaw saayug waajur wi	Wàll:Dundug Seex Ahmadu Bamba;
SancamJolof Ak li ko waraloon	Wàll:Dundug Seex Ahmadu Bamba;
Tukkib géej gi	Wàll:Dundug Seex Ahmadu Bamba;
Dugg ci gaal gi juge Ndakaaru	Wàll:Dundug Seex Ahmadu Bamba;
Dellusi gi juge ca géej ga	Wàll:Dundug Seex Ahmadu Bamba;
Ñaareelu tukki bi (bu Gànnaar bi)	Wàll:Dundug Seex Ahmadu Bamba;
Ñibbisi gi jugge Gànnaar	Wàll:Dundug Seex Ahmadu Bamba;
Ag génnam juge Jolof jëm Njaaréem	Wàll:dundug Seex Ahmadu Bamba;
Tëjte	Wàll:Dundug Seex Ahmadu Bamba;
Seere yi ko mag ñi seereel ag màgg akug wilaaya	Wàll:Dundug Seex Ahmadu Bamba;
Suuf	Wàll:Suuf| ;
Niiruw jant	Wàll:saytubiddiw;
Nosteg jant	Wàll:Saytubiddiw;
Jant	Wàll:Saytubiddiw;
Melosuufug Angolaa	Wàll:Melosuufug afrig|Angolaa;Wàll:Angolaa;
Yoonal	Wàll:Yoon;
Wéyal	Wàll:Yoon;
Dalub web	Wàll:Xam-xamu nosukaay;
Almazán	Wàll:Ispaañ;
Xëtu web	Wàll:Xam-xamu nosukaay;
Breinigerberg	Wàll:Almaañ;
Internet	Wàll:Xam-xamu nosukaay;
Lëkkalekaay	Wàll:Xam-xamu nosukaay;
Njàngale	Wàll:Njàngale;
Yamoo	Wàll:Melosuuf;
Màkkaanum mbëjfeppal	Wàll:Xam-xamu nosukaay;
Melosuufug Senegaal	Wàll:melosuufug Senegaal;
Weer	Wàll:Arminaat;Wàll:Jamono;
Royuwaay:Arminaat	Wàll:Royuwaay;
Bés	Wàll:Bés| ;Wàll:Jamono;
Royuwaay:En	Wàll:Royuwaay;
Royuwaay:Fr	Wàll:Royuwaay;
Pullaar	Wàll:Làkki senegaal;
Fatik	Wàll:réewi-taaxi Senegaal;
Kawlak	Wàll:réewi-taaxi Senegaal;
Amsterdam	Wàll:Olaand;Wàll:Péy;
Royuwaay:Téereb Injiil	Wàll:Royuwaay diine;
Diiwaanu Ndakaaru	Wàll:diiwaani Senegaal;
Diiwaanu Njaaréem	Wàll:diiwaani Senegaal;
Diiwaanu Fatik	Wàll:diiwaani Senegaal;
Fodé Camara	Wàll:Cuub;
Uetersen	Wàll:Almaañ;
Kureelu tembte bu Poortorikoo	Wàll:Poortorikoo;
Diiwaanu Kawlax	Wàll:diiwaani Senegaal;
Diiwaanu Koldaa	Wàll:diiwaani Senegaal;
Diiwaanu Cees	Wàll:diiwaani Senegaal;
Diiwaanu Ndar	Wàll:Diiwaani Senegaal;
Diiwaanu Luga	Wàll:diiwaani Senegaal;
Diiwaanu Siggcoor	Wàll:diiwaani Senegaal;
Diiwaanu Maatam	Wàll:diiwaani Senegaal;
Diiwaanu Tambaakundaa	Wàll:Diiwaani Senegaal;
Dexub Senegaal	Wàll:Wali ndox yu Senegaal;
Wu-angalteer	Wàll:Làkk;Wàll:Nguur-Yu-Bennoo;
Gëwéel	Wàll:Gëwéel;
Royuwaay:Infobox Dëkk	Wàll:Infobox|Dëkk;
Royuwaay:SEN	Wàll:Royuwaay raaya réew|{{PAGENAME}};Wàll:Senegaal| ;
Royuwaay:IRL	Wàll:Royuwaay raaya réew|{{PAGENAME}};Wàll:Irlaand| ;
Royuwaay:Boyutu jëfëndikookat	:Wàll:{{{wàll}}}|∇;Wàll:{{{wàll}}}|{{PAGENAME}};Wàll:{{{wàll2}}}|{{PAGENAME}};Wàll:Boyutu jëfëndikookat|*;
Royuwaay:Boyutu Babel	Wàll:Boyutu Babel|*;
Royuwaay:Boyutu Babel 1	Wàll:Jëfandikukat {{{làkk}}}-1|{{PAGENAME}};Wàll:Boyutu Babel 1|* Boyutu Babel 1;
Royuwaay:Boyutu Babel 2	Wàll:Jëfandikukat {{{làkk}}}-2|{{PAGENAME}};Wàll:Boyutu Babel 2|* Boyutu Babel 2;
Royuwaay:Boyutu Babel 3	Wàll:Jëfandikukat {{{làkk}}}-3|{{PAGENAME}};Wàll:Boyutu Babel 3|* Boyutu Babel 3;
Royuwaay:Boyutu Babel 4	Wàll:Jëfandikukat {{{làkk}}}-4|{{PAGENAME}};Wàll:Boyutu Babel 4|* Boyutu Babel 4;
Royuwaay:Boyutu Babel 5	Wàll:Jëfandikukat {{{làkk}}}-5|{{PAGENAME}};Wàll:Boyutu Babel 5|* Boyutu Babel 5;
Royuwaay:Boyutu Babel N	Wàll:Jëfandikukat {{{làkk}}}-N|{{PAGENAME}};Wàll:Boyutu Babel N|* Boyutu Babel N;
Royuwaay:Boyutu Babel 0	Wàll:Jëfandikukat {{{làkk}}}-0|{{PAGENAME}};Wàll:Boyutu Babel 0|* Boyutu Babel 0;
Royuwaay:Jëfandikukat fr	:Wàll:Jëfandikukat fr-N|langue maternelle;:Wàll:Jëfandikukat fr|français;Wàll:Boyutu Babel N|fr;Wàll:Jëfandikukat fr|N;
Royuwaay:Jëfandikukat en-3	:Wàll:Jëfandikukat en-3|advanced;:Wàll:Jëfandikukat en|English;Wàll:Boyutu Babel 3|en;Wàll:Jëfandikukat en|3;
Madrid	Wàll:Ispaañ;Wàll:Péy;
Zurich	Wàll:Suwis;Wàll:Dëkk;
Rom	Wàll:Itaali;Wàll:Péy;
Yàlla	Wàll:Diine;
Tus	Wàll:Xayma;
Benn	Wàll:Xayma;
Minsk	Wàll:Belaarus;Wàll:Péy;
Sofiya	Wàll:Bulgaari;Wàll:Péy;
Prag	Wàll:Réewum Cek;Wàll:Péy;
Budapest	Wàll:Oonguri;Wàll:Péy;
Kisinawu	Wàll:Péy;Wàll:Moldaawi;
Warsaw	Wàll:Poloñ;Wàll:Péy;
Bukarest	Wàll:Romaani;Wàll:Péy;
Mosku	Wàll:Riisi;Wàll:Péy;
Baratislawa	Wàll:Eslowaaki;Wàll:Péy;
Kopenagen	Wàll:Danmaark;Wàll:Péy;
Talin	Wàll:Estooni;Wàll:Péy;
Elsinki	Wàll:Finlaand;Wàll:Péy;
Reykjawik	Wàll:Islaand;Wàll:Péy;
Dublin	Wàll:Irlaand;Wàll:Péy;
Riga	Wàll:Letóoni;Wàll:Péy;
Wilniyus	Wàll:Lituwaani;Wàll:Péy;
Oslo	Wàll:Noorwees;Wàll:Péy;
Stokolm	Wàll:Suweed;Wàll:Péy;
Londar	Wàll:Nguur-Yu-Bennoo;Wàll:Péy;
Tirana	Wàll:Albaani;Wàll:Péy;
Andorra la Vella	Wàll:Andoor;Wàll:Péy;
Saarayego	Wàll:Bosni;Wàll:Péy;
Sagreb	Wàll:Korwaasi;Wàll:Péy;
Skopje	Wàll:Réewum Maseduwaan;Wàll:Péy;
Waleta	Wàll:Malt;Wàll:Péy;
Montenegro	Wàll:Tugal;Wàll:Réew;Wàll:Montenegro;
Melo	Wàll:Melo| ;
Royuwaay:Bot	Wàll:Global bot;Wàll:Local bot;Wàll:Inactif bot;Wàll:Bot Wikipedia;:Wàll:Global bot;:Wàll:Local bot;:Wàll:Inactif bot;:Wàll:Bot Wikipedia;
Xonq	Wàll:Melo;
Mboq	Wàll:Melo;
Wert	Wàll:Melo;
Baxa	Wàll:Melo;
Daaray Sëriñ Tuubaa	Wàll:Yoonu murit;
Podgorika	Wàll:Montenegro;Wàll:Péy;
Lisbon	Wàll:Portugaal;Wàll:Péy;
San Marino (péy)	Wàll:san Marino;Wàll:Péy;
Belgrad	Wàll:Seerbi;Wàll:Péy;
Jubaljana	Wàll:Esloweeni;Wàll:Péy;
Watikaa (péy)	Wàll:Watikaa;Wàll:Péy;
Wiyen	Wàll:Ótiris;Wàll:Péy;
Burusel	Wàll:Beljik;Wàll:Péy;
Wadus	Wàll:Liechtenstein;Wàll:Péy;
Luksambuur (péy)	Wàll:Luksambuur;Wàll:Péy;
Monaako (péy)	Wàll:Péy;Wàll:Monaako;
Bern	Wàll:Suwis;Wàll:Péy;
Astana	Wàll:Kasakistaan;Wàll:Péy;
Baku	Wàll:Aserbayjaan;Wàll:Péy;
Tibilisi	Wàll:Jeoorji;Wàll:Péy;
Ankara	Wàll:Tirki;Wàll:Péy;
Linux	Wàll:Xam-xamu nosukaay;
Ubbite	Wàll:Mamoor Xam Sa Diine;
Arafu A	Wàll:Mamoor Xam Sa Diine;
Arafu B	Wàll:Mamoor Xam Sa Diine;
Arafu J	Wàll:Mamoor Xam Sa Diine;
Arafu D	Wàll:Mamoor Xam Sa Diine;
Arafu W	Wàll:Mamoor Xam Sa Diine;
Arafu y	Wàll:Mamoor Xam Sa Diine;
Arafu M	Wàll:Mamoor Xam Sa Diine;
Arafu N	Wàll:Mamoor Xam Sa Diine;
Arafu F	Wàll:Mamoor Xam Sa Diine;
Arafu X Q	Wàll:Mamoor Xam Sa Diine;
Arafu R	Wàll:Mamoor Xam Sa Diine;
Arafu S	Wàll:Mamoor Xam Sa Diine;
Arafu T	Wàll:Mamoor Xam Sa Diine;
Ag Mottali	Wàll:Mamoor Xam Sa Diine;
Football	Wàll:Football;
Lu am ag séqoo ak njàppum jaam	Wàll:Taariix|*;
Gordon Brown	Wàll:Nguur-Yu-Bennoo;
Manchester United	Wàll:Nguur-Yu-Bennoo;Wàll:Football;
Premier League	Wàll:Football;Wàll:Angale;
Alex Ferguson	Wàll:Football;
MediaWiki:Edittools	Wàll:+;
Asamaan	Wàll:Suuf;Wàll:Saytubiddiw;
Ndox	Wàll:Ndox;
Safara	Wàll:Safara;
Gόor	Wàll:Gόor;
Jigéen	Wàll:Jigéen;
Wu-faraas	Wàll:Faraas;Wàll:Làkk;
Mburu	Wàll:Mburu;
Guddi	Wàll:Suuf;Wàll:Bés;
Sëriñ Saaliwu Mbàkke	Wàll:yoonu murit;Wàll:niti senegaal;
MediaWiki:Gadget-HotCats.js	Wàll:" + hnc + "$2;Wàll:" + hrc + ";Wàll:" + hnc + ";Wàll:" + hrc + ";Wàll:" + hnc + ";Wàll:" + hnc + ";
MediaWiki:Gadget-DeluxeHistory.js	Wàll:MediaWiki:Fonction Monobook en JavaScript;
Sëriñ Mbay JAXATE	Wàll:Niti senegaal;Wàll:Yoonu murit;
Dun	Wàll:Dun| ;
Ayubés	Wàll:Arminaat;
Dibéer	Wàll:Arminaat;
Altine	Wàll:Arminaat;
Talaata	Wàll:Arminaat;
Àllarba	Wàll:Arminaat;
Alxames	Wàll:Arminaat;
Àjjuma	Wàll:Arminaat;
Gaawu	Wàll:Arminaat;
Ñaar	Wàll:Xayma;
Ñatt	Wàll:Xayma;
Juroom	Wàll:Xayma;
Juróom benn	Wàll:Xayma;
Juróom ñaar	Wàll:Xayma;
Juróom ñett	Wàll:Xayma;
Juróom ñent	Wàll:Xayma;
Fukk	Wàll:Xayma;
Fajar	Wàll:Bés;
Njël	Wàll:Bés;
Diiwaanu Kafrin	Wàll:Diiwaani Senegaal;
Diiwaanu Kéedugu	Wàll:Diiwaani Senegaal;
Diiwaanu Séeju	Wàll:Diiwaani Senegaal;
Xavier Rovira Rojas	Wàll:Sport;
Ngéej	Wàll:Melosuuf;Wàll:Ndox;
Xaj	Wàll:Rab;
Muus	Wàll:Rab;
Jasaan	Wàll:Jén;
Piipa	Wàll:Rab;
Garab	Wàll:Xam-xam;
Mori	Wàll:Jén;
Ndiané	Wàll:Jén;
Bëer	Wàll:Jén;
Khal	Wàll:Jén;
Fötö	Wàll:Jén;
Fëtt	Wàll:Jén;
Royuwaay:Bokktekki	Wàll:Bokktekki;Wàll:Royuwaay|Bokktekki;
Thiékem	Wàll:Jén;
Djabar	Wàll:Jén;
Njagatun	Wàll:Jén;
Rap	Wàll:Hip Hop;
Hip-hop	Wàll:Hip Hop;
Break dancing	Wàll:Hip Hop;
Melosuufug Bene	Wàll:bene;Wàll:melosuufug afrig;
Nahju	Wàll:Yoonu murit;
Melosuufug Botswana	Wàll:botswana;Wàll:melosuufug afrig;
Waxi Seex Anta Jóob	Wàll:Kàllaama;
Royuwaay:Tëralin	Wàll:Royuwaay;
Banda	Wàll:Jén;
Wersun	Wàll:Jén;
Melosuufug Burkinaa Faaso	Wàll:Burkinaa Faaso;
Melosuufug Buruundi	Wàll:Buruundi;
Melosuufug Kamerun	Wàll:melosuufug Kamerun|melosuufug Kamerun;
Ngaté yénnö	Wàll:Jén;
Ngaté bu digen	Wàll:Jén;
Buum	Wàll:baati wolof;
Ceññeer-mbej	Wàll:baati wolof;Wàll:Jëmm;Wàll:Kàttan;
Ngiste	Wàll:Baati wolof;
Mbëjbijjaakon	Wàll:mbëjbijjaakon;
Goxub Dottub Bëj-saalum	Wàll:Gox yi;Wàll:Diiwaani dott;
Xarey jóoñe	Wàll:Politig;Wàll:Baati wolof;Wàll:Taariixu Tugal;Wàll:Taariixu Asi;
Royuwaay:Jëfandikukat eu	:Jëfandikukat eu-N|euskaldun zahar;:Jëfandikukat eu|euskara;
Royuwaay:Jëfandikukat ca-4	:Jëfandikukat ca-4|parlant natiu;:Jëfandikukat ca|català;
Royuwaay:Jëfandikukat cs	:Wàll:Jëfandikukat cs|čeština;:Wàll:Jëfandikukat cs-N|mateřským jazykem;Wàll:Boyutu Babel N|cs;Wàll:Jëfandikukat cs|N;
Royuwaay:Jëfandikukat hu	:Jëfandikukat hu|magyar;:Jëfandikukat hu-N|anyanyelve;
Royuwaay:Jëfandikukat is-1	:Jëfandikukat is-1|grundvallarkunnáttu;:Jëfandikukat is|íslensku;
Royuwaay:Jëfandikukat fi	:Jëfandikukat fi|suomea;:Jëfandikukat fi-N|äidinkielenään;
Royuwaay:Jëfandikukat id-3	:Jëfandikukat id|bahasa Indonesia;:Jëfandikukat id-3|mahir;
Royuwaay:Jëfandikukat el-1	:Jëfandikukat el-1|βασικού;:Jëfandikukat el|ελληνικά;
Royuwaay:Jëfandikukat io-3	:Jëfandikukat io-3|alta;:Jëfandikukat io|Ido;
Royuwaay:Jëfandikukat ia-2	:Jëfandikukat ia-2|intermedie;:Jëfandikukat ia|interlingua;
Royuwaay:Jëfandikukat et-1	:Jëfandikukat et|eesti keeles;:Jëfandikukat et-1|algaja;
Royuwaay:Jëfandikukat lb-1	:Jëfandikukat lb-1|mat Grondkenntnisser;:Jëfandikukat lb|Lëtzebuerger Sprooch;
Royuwaay:Jëfandikukat hi-1	:Jëfandikukat hi|हिन्दी;:Jëfandikukat hi-1|प्रारंभिक;
Royuwaay:Jëfandikukat ar-1	:Jëfandikukat ar-1|مبادئ;:Jëfandikukat ar|&#1575;&#1604;&#1593;&#1585;&#1576;&#1610;&#1577;;
Royuwaay:Jëfandikukat ka-1	:Jëfandikukat ka|ქართული ენის;:Jëfandikukat ka-1|ელემენტარულ;
Royuwaay:Jëfandikukat vo-1	:Jëfandikukat vo-1|bapiko;:Jëfandikukat vo|Volapüki;
Royuwaay:Jëfandikukat yi-2	:Jëfandikukat yi-2|&#1520;&#64287;&#1496;&#1492;&#1488;&#1463;&#1500;&#1496;&#1506;&#1512;;:Jëfandikukat yi|&#1497;&#1497;&#1460;&#1491;&#1497;&#1513;;
Goxub Dottub Bëj-gànnaar	Wàll:Gox yi;Wàll:Diiwaani dott;
Royuwaay:Réewi tugal	Wàll:Royuwaay séwógaraafi mu réew;
Séddaliinu yoriinu Senegaal	Wàll:dogiinu Senegaal;
Aw xët ci wàll gii	Wàll:Diiwaani Senegaal|*;
Louvre	Wàll:Faraas;
Daara yu diggu	Wàll:yar;Wàll:baati wolof;
Cig jonjoodi	Wàll:Jokkoo;
Dóox	Wàll:Taariix;
Ndefar gu barab gi	Wàll:Endustri;
Nosteg galag	Wàll:Koom-koom;
Bennoo gu Almaañ	Wàll:Taariixu Tugal;
Baatukaay	Wàll:Làkk;Wàll:Njàngale;
Royuwaay:Km²	Wàll:Royuwaay séwógaraafi;
Sompat	Wàll:Jén;
1 Korent	Wàll:Leeral Biibël;
2 Piyeer	Wàll:Leeral Biibël;
Royuwaay:Km2	Wàll:Royuwaay séwógaraafi;
Tundi Senegaal	Wàll:tundi Senegaal;
Royuwaay:Tundi senegaal	Wàll:Royuwaay séwógaraafi;
Diiwaani Senegaal	Wàll:diiwaani Senegaal;
Ndiiwaani Senegaal	Wàll:Ndiiwaani Senegaal;
Aakimoo jawwu ji	Wàll:Aakimoo jawwu ji;
Jeqiku gi xam-xam amal ci Elektron	Wàll:Jëmm;Wàll:Jëmm;
Fepp	Wàll:Jëmm;
Bijjaakon	Wàll:Jëmm;
As yaram	Wàll:Jëmm;
Njabootug lepton	Wàll:Jëmm;
Lepton	Wàll:Jëmm;
Nukleon	Wàll:Jëmm;
Limub njiiti Senegaal yil	Wàll:njiiti Senegaal;
Dëkkaani ndiiwaani Senegaal	Wàll:Dëkkaani ndiiwaani Senegaal;
Yolet	Wàll:Melo;
Ñent	Wàll:Xayma;
Royuwaay:Oppose	Wàll:Royuwaay|Oppose;
Wikipedia:Yorkat	Wàll:Barab Wikipedia|{{PAGENAME}};
Royuwaay:Coord	Wàll:Royuwaay Coord| ;
Royuwaay:Coord/display/inline	Wàll:Royuwaay Coord|display/inline;
Royuwaay:Coord/input/dms	Wàll:Royuwaay Coord|input/dms;
Royuwaay:Coord/input/dec	Wàll:Royuwaay Coord|input/dec;
Royuwaay:Coord/dec2dms	Wàll:Royuwaay Coord|dec2dms;
Royuwaay:Coord/prec dec	Wàll:Royuwaay Coord|prec dec;
Royuwaay:Coord/link	Wàll:Royuwaay Coord|link;
Royuwaay:Coord/dec2dms/dms	Wàll:Royuwaay Coord|dec2dms/dms;
Royuwaay:Coord/dec2dms/d	Wàll:Royuwaay Coord|dec2dms/d;
Royuwaay:Coord/dec2dms/d1	Wàll:Royuwaay Coord|dec2dms/d1;
Royuwaay:Coord/dec2dms/dm	Wàll:Royuwaay Coord|dec2dms/dm;
Royuwaay:Coord/dec2dms/dm1	Wàll:Royuwaay Coord|dec2dms/dm1;
Royuwaay:Coord/dec2dms/dms1	Wàll:Royuwaay Coord|dec2dms/dms1;
Royuwaay:Coord/display/inline,title	Wàll:Royuwaay Coord|display/inline,title;
Royuwaay:Coord/dms2dec	Wàll:Royuwaay Coord|dms2dec;
Royuwaay:Coord/input/d	Wàll:Royuwaay Coord|input/d;
Royuwaay:Coord/input/dm	Wàll:Royuwaay Coord|input/dm;
Royuwaay:Coord/input/dms long	Wàll:Royuwaay Coord|input/dms long;
Royuwaay:Coord/display/title	Wàll:Royuwaay Coord|display/title;
Royuwaay:Coord/input/dm long	Wàll:Royuwaay Coord|input/dm long;
Royuwaay:Coord/input/ERROR	Wàll:Royuwaay Coord|input/error;
Royuwaay:Coord/URL	Wàll:Royuwaay Coord|URL;
Oiapoque	Wàll:Breesil;
Toulouse	Wàll:Faraas;
Lourdes	Wàll:Faraas;
Yoonu murit	Wàll:yoonu murit;
Sëriñ Abdul Ahad Mbàkke	Wàll:Niti senegaal;Wàll:Yoonu murit;
Sëriñ Muhammadu Faliilu Mbàkke	Wàll:Niti senegaal;Wàll:Yoonu murit;
Muhammadu Mustafaa Mbàkke	Wàll:Niti senegaal;Wàll:Yoonu murit;
Sëriñ Abdu Xaadir Mbàkke	Wàll:Niti senegaal;Wàll:Yoonu murit;
Baay Faal	Wàll:Yoonu murit;
Seex Ibraayma Faal	Wàll:yoonu murit;Wàll:niti senegaal;
Xelkoom	Wàll:dëkk-dëkkaani Senegaal;Wàll:yoonu murit;
Beeco Cuun	Wàll:yoonu murit;Wàll:niti senegaal;
Seex Muhammadu Murtalaa Mbàkke	Wàll:Niti senegaal;Wàll:Yoonu murit;
Royan	Wàll:Faraas;
Sëriñ Suhaybu Mbàkke	Wàll:Niti senegaal;Wàll:Yoonu murit;
Sëriñ Basiiru Mbàkke	Wàll:Niti senegaal;Wàll:Yoonu murit;
Abdulaay Wàdd	Wàll:niti senegaal;Wàll:Njiiti Senegaal;
Sëñ Masàmba	Wàll:Niti senegaal;Wàll:Yoonu murit;
Xarey àdduna	Wàll:xarey àdduna;
Lislaam	Wàll:Lislaam;Wàll:Yoonu murit;
Kiswahili	Wàll:Làkki Niseer-Cóngoo;Wàll:Làkki Afrig;
Wikipedia:Bot	:Wàll:Global bot;:Wàll:Global bot|Catégorie:bot global;:Wàll:Global bot|global bot;:Wàll:Réew;:Wàll:Réew;Wàll:Barab Wikipedia;Wàll:Bot Wikipedia| ;
Royuwaay:It	Wàll:Royuwaay;
Campora San Giovanni	Wàll:Itaali;
Weeri wolof	Wàll:Lislaam;Wàll:Arminaat;Wàll:Weeri wolof;
Réewi lebu yi	Wàll:Taariixu senegaal;Wàll:nguuri senegaal;
Kumba Ndóofeen Famak Juuf	Wàll:Taariixu senegaal;Wàll:Niti senegaal;Wàll:Niti Gàmbi;Wàll:Cosaan;Wàll:Séeréer;Wàll:Cosaan Séeréer;
Mandinke	Wàll:Taariixu senegaal;
Ceddo	Wàll:Taariixu senegaal;Wàll:Taariixu Gàmbi;Wàll:Cosaan Séeréer;Wàll:Cosaan;
Màbba Jaxu Ba	Wàll:Taariixu senegaal;Wàll:Niti senegaal;Wàll:Niti Gàmbi;Wàll:Cosaan;
Tekuruur	Wàll:Taariixu senegaal;Wàll:Cosaan Séeréer;
Sooninke	Wàll:taariixu senegaal;
Séeréer	Wàll:Taariixu senegaal;Wàll:Làkki senegaal;Wàll:Niti senegaal;[[Wàll:Waasoy Senegaal;
Wolof (askan)	Wàll:waasoy Senegaal;
Pël	Wàll:waasoy senegaal;Wàll:Làkki Senegaal;
Tukkloor	Wàll:waasoy Senegaal;Wàll:Taariixu senegaal;
Joolaa (askan)	Wàll:Waasoy Senegaal;
Royuwaay:Es	Wàll:Royuwaay;
Royuwaay:De	Wàll:Royuwaay;
Đồng Hới	Wàll:Wiyetnaam;
Namandiru	Wàll:Senegaal;
World Wide Web	Wàll:Xam-xamu nosukaay;
Royuwaay:Jëfandikukat pl-1	:Wàll:Jëfandikukat pl|językiem polskim;:Wàll:Jëfandikukat pl-1|podstawowym;
Royuwaay:Bataaxalu dalal-jàmm	Wàll:Royuwaay;
Ndimbal ci ay nataal	Wàll:Ndimbal;
Réewum ñaari dex yi	Wàll:Taariix;Wàll:Iraak;
Buyumbura	Wàll:Buruundi;Wàll:Péy;
Praia	Wàll:Péy;Wàll:Kap Weer;
Nuwaaksot	Wàll:Gànnaar;Wàll:Péy;
Amman	Wàll:Péy;Wàll:Jordaani;
Bagdad	Wàll:Iraak;Wàll:Péy;
Turu Way-Dëkk	Wàll:Réew;
Njëkk-xaymà	Wàll:Réew;
Koppar	Wàll:Koom-koom;
Yaatuwaay	Wàll:Melosuuf;
Moroni	Wàll:Péy;Wàll:Komoor;
Way-dëkk	Wàll:Melosuuf;
Nasaraan	Wàll:Diine;
Tembte	Wàll:Politig;Wàll:Taariix;
Dencukaay	Wàll:Xam-xamu nosukaay;
Royuwaay:Infobox Réew	:Wàll:Péy|Péy;Wàll:Infobox;
Gaynde	Wàll:Rab;
Looy	Wàll:Rab;
Tene	Wàll:Rab;
Nguri	Wàll:Gunóor;
Suraas	Wàll:Melo;
Royuwaay:Xóotal	Wàll:Royuwaay;
Wure	Wàll:Fo;
Esaas	Wàll:Simi;Wàll:Kàttan;
Téeméer	Wàll:Xayma;
Junni	Wàll:Xayma;
Kër	Wàll:Kër;
Paaka	Wàll:Suti;Wàll:Waañ;
Waañ	Wàll:Waañ;
Furset	Wàll:Suti;Wàll:Waañ;
Kuddu	Wàll:Suti;Wàll:Waañ;
Aset	Wàll:Suti;Wàll:Waañ;
Mbaam	Wàll:Rab;
Dundat yi	Wàll:Dundat yi;
Iyon-jawwu	Wàll:Suuf;Wàll:Jëmm;
Waxtu	Wàll:Jamono;
At	Wàll:Arminaat;Wàll:Jamono;
Simili	Wàll:Jamono;
Saa	Wàll:Jamono;
Gaal	Wàll:Moto;
Ganaar	Wàll:Rab;
Bët	Wàll:Rab;
Soviet Yi Benno	Wàll:Tugal;Wàll:Asi;
Jimbulang	Wàll:Jimbulang| ;
Tangor	Wàll:Melosuuf;Wàll:Saytubiddiw;
Yay	Wàll:Yay| ;
Saara	Wàll:Yay;Wàll:Melosuufug afrig;
Max	Wàll:Gunóor;
Gunóor	Wàll:Gunóor| ;
Melentaan	Wàll:Gunóor;
Sharles Degóol	Wàll:Faraas;
Wolof	Wàll:Wolof;
Jimbulang bu waa-Brëtaañ	Wàll:Jimbulang;
Samwie	Wàll:Samwie;Wàll:Weeri at mi;
Fewirie	Wàll:Weeri at mi;Wàll:Fewirie;
Maars (weer)	Wàll:Weeri at mi;Wàll:Maars;
Awril	Wàll:Weeri at mi;Wàll:Awril;
Ségg	Wàll:Rab;
Golo	Wàll:Rab;
Ñay	Wàll:Rab;
Nag	Wàll:Rab;
Dàngin	Wàll:Rab;
Jinax	Wàll:rab;
Mee	Wàll:Weeri at mi;Wàll:Mee;
Suwe	Wàll:Weeri at mi;Wàll:Suwe;
Sulet	Wàll:Weeri at mi;Wàll:Sulet;
Waxset	Wàll:Weeri at mi;Wàll:Ut;
Royuwaay:Weer	Wàll:Royuwaayu weer|Weer;
Satumbar	Wàll:Weeri at mi;Wàll:Sattumbar;
Oktoobar	Wàll:Weeri at mi;Wàll:Oktoobar;
Nowembar	Wàll:Weeri at mi;Wàll:Nowembar;
Disambar	Wàll:Weeri at mi;Wàll:Disambar;
Royuwaay:Weeriwolof	Wàll:Royuwaayu weer;
Tamxarit	Wàll:weeri wolof;
Diggi-gàmmu	Wàll:weeri wolof;
Gàmmu	Wàll:weeri wolof;
Xareb Àdduna bu Njëkk	Wàll:Xarey àdduna;
Diiney Afrig	Wàll:diine;Wàll:Afrig;
Waxtaani sëriñ tuubaa	Wàll:Yoonu murit;
Royuwaay:Mbàmbulaan	Wàll:royuwaayu melosuuf|mbàmbulaan;
Sëriñ Maalig Basin Si	Wàll:Niti senegaal;Wàll:Yoonu murit;
Waxi Sëriñ Maalig Basin Si	Wàll:Senegaal;Wàll:Yoonu murit;
Rakki-gàmmu	Wàll:weeri wolof;
Rakkaati-gàmmu	Wàll:weeri wolof;
Maami-koor	Wàll:weeri wolof;
Ndeyi-koor	Wàll:weeri wolof;
Baraxlu	Wàll:weeri wolof;
Kori	Wàll:weeri wolof;
Diggi-tabaski	Wàll:weeri wolof;
Tabaski	Wàll:Weeri wolof;
Njëkk-taariix	Wàll:Njëkk-taariix;
Waxi Seex Anta ci lu aju ci cosaanul nit	Wàll:Taariix;
Ecser	Wàll:Oonguri;
Fànn	Wàll:Fànn;
Besançon	Wàll:Faraas;
Nosteg doxiin	Wàll:Xam-xamu nosukaay;
Royuwaay:Latn	Wàll:Royuwaay|Latn;
Wikbaatukaay	Wàll:Baatukaay;Wàll:Sémbi Wikimedia Fondation;
Tëriinuw nosukaay	Wàll:Xam-xamu nosukaay;
PHP	Wàll:Xam-xamu nosukaay;
HTML	Wàll:Xam-xamu nosukaay;
ASP.NET	Wàll:Xam-xamu nosukaay;
Royuwaay:BUR	Wàll:royuwaay raaya réew|Buruundi;
Royuwaay:KOM	Wàll:royuwaay raaya réew;
Royuwaay:MLW	Wàll:royuwaay raaya réew|Malawi;
Royuwaay:MOR	Wàll:royuwaay raaya réew|Móoris;
Royuwaay:MYT	Wàll:royuwaay raaya réew|Mayot;
Royuwaay:CAD	Wàll:royuwaay raaya réew|Cadd;
Bujumbura	Wàll:Buruundi;
Jibuti (dëkk)	Wàll:Jibuti;
Asmara	Wàll:eritere;
Addis-Abeba	Wàll:Ecoopi;
Nairobi	Wàll:Keeñaa;
Kampala	Wàll:Ugandaa;
Antananariwo	Wàll:Madagaskaar;
Lilongwe	Wàll:Malawi;
Mamudsu	Wàll:Mayot;
Maputo	Wàll:Mosambik;
Kigali	Wàll:Ruwandaa;
Wiktoria (Seysel)	Wàll:Seysel;
Mogadisu	Wàll:Somali;
Dodoma	Wàll:Tansani;
Tus-wu-taxaw	Wàll:Melosuuf;
Lusaka	Wàll:Saambi;
Arare	Wàll:Simbaawee;
Luanda	Wàll:Angolaa;
Yaunde	Wàll:Kamerun;
Bangi	Wàll:Réewum Diggu Afrig;
Njamena	Wàll:Cadd;
Brasawil	Wàll:Kongóo;
Kinshasa	Wàll:Kongóo-Kinshasa;
Malabo	Wàll:Gineg yamoo;
Libarwil	Wàll:Gaboŋ;
Sao Tome (dun)	Wàll:Sao Tome ak Principe;
Alse	Wàll:Alseeri;
Xayra	Wàll:Isipt;
Tripoli (Libi)	Wàll:Libi;Wàll:Péeyi afrig;
Rabat	Wàll:Marok;
Planoise	Wàll:Faraas;
Xartum	Wàll:Sudaan;
Tunis	Wàll:Tiniisi;
Royuwaay:CcTLD	Wàll:barab bu tolluwaay bu njëkk;
.ac	Wàll:Barab bu tolluwaay bu njëkk;
Duni Kanaari	Wàll:Kanaari;
Las Palmasu Kanaari gu Mag	Wàll:Kanaari;
Niccolò Machiavelli	Wàll:Njàngat;Wàll:Politig;Wàll:Itaali;
Muurum Koor	Wàll:lislamm;
Niels Bohr	Wàll:Jëmm;
Charles Darwin	Wàll:Dundat yi;
Haj	Wàll:Ponki Lislaam;
Bisub Tabaski	Wàll:Lislaam;
Royuwaay:Jëfandikukat io-1	:Jëfandikukat io-1|basa;:Jëfandikukat io|Ido;
Bundesliga	Wàll:Football;Wàll:Almaañ;
Dawaan bu wéy	Wàll:Dawaanu mbëj;
Dawaan bu safaanu	Wàll:Dawaanu mbëj;
Dawaanu mbëj	Wàll:Dawaanu mbëj;Wàll:Xaralaymbëj;
Soppalikaay	Wàll:Xaralaymbëj;
Royuwaay:Far	Wàll:Far;Wàll:Royuwaay;
Xët wu njëkk	Wàll:Xët wu njëkk;
Kàttanug mbëj	Wàll:Kàttan;
Daanaka-dun	Wàll:Melosuuf;
Toolu mbëj	Wàll:Mbëj;
Mbëjfepp	Wàll:Jëmmu saal;
Màggalug Tuubaa	Wàll:Yoonu murit;
Bisu Tamxarit	Wàll:diine;Wàll:Lislaam;
Feppsaal	Wàll:Jëmmu saal;
Feppmaandu	Wàll:Jëmmu saal;
Xarefulwoon	Wàll-wàllaan wu njëlbeen|ronxarefulwoon;Wàll:Jëmmu saal;
Toolu bijjaakon	Wàll:Bijjaakon;
Toolu mbëjbijjaakon	Wàll:Mbëjbijjaakon;
Yanu mbëj	Wàll:Mbëj;
Ndëgërlu gu mbëj	Wàll:Mbëj;
Dëgërluwiin	Wàll:Mbëj;
Wommatiinu mbëj	Wàll:mbëj;
Wommat wu mbëj	Wàll:mbëj;
Dëgërlukaay	Wàll:Mbëj;
Jurukaayu mbëj	Wàll:Xaralaymbëj;
Dendu mbëj	Wàll:Xaralaymbëj;
Safaanukaay	Wàll:Wuutuloxo yu mbëj;
Doxalukaay bu demandoodi	Wàll:wuutuloxo yu mbëj;
Raaya wu Senegaal	Wàll:Afrig;Wàll:Réew;Wàll:Senegaal;Wàll:Raaya;
Dereet	Wàll:jëmm;Wàll:yaram;
Jullit	Wàll:Diine;Wàll:Lislaam;
Cosug àdduna bi ak Big Bang	Wàll:taariix;Wàll:Lislaam;
Doxalukaay bu demandoo	Wàll:wuutuloxo yu mbëj;
Qin Shi Huang	Wàll:Taariix;Wàll:Siin;
Soxna Jaara BUSO	Wàll:Lislaam;Wàll:Yoonu murit;
Mbëjbijjaan	Wàll:Xaralaymbëj;
Bijjaan	Wàll:Mbëjbijjaakon;
Wuutuloxo bu mbëj	Wàll:xaralaymbëj;
Xiirtalu	Wàll:mbëj;
Xiirtalukaay	Wàll:mbëj;
Baraay	Wàll:Kemi jëmm;
Xiirtalug mbëjbijjaakon	Wàll:mbëjbijjaakon;
Ho Chi Minh City	Wàll:Wiyetnaam;
Ndombo gu mbëj	Wàll:Mbëj;
Royuwaay:Jëfandikukat ca	:Wàll:Jëfandikukat en|català;:Wàll:Jëfandikukat ca-N|primera llengua;Wàll:Boyutu Babel N|ca;Wàll:Jëfandikukat ca|N;
Fattalukaay(mbëj)	Wàll:Mbëj;
Tunduw Ndakaaru	Wàll:tundi Senegaal;
Coronel Fabriciano	Wàll:Breesil;
Al Bayda	Wàll:Lybia;
Xolaxol	Wàll:Picc;
Toq	Wàll:Picc;
Tan	Wàll:Picc;
Ngóora (jëmm)	Wàll:Kemi jëmm;
Liggéey (jëmm)	Wàll:Doolerandu;Wàll:Kemi jëmm;
Kàttanug imbiku	Wàll:kàttan;Wàll:doolerandu;
Mbëjtekkaaral	Wàll:mbëjtekkaaral;
Esperanto	Wàll:Làkk;
Şalom	Wàll:Titre de presse créé en 1947;Wàll:Presse écrite hebdomadaire;Wàll:Presse écrite turque;Wàll:Presse écrite en turc;Wàll:Culture judéo-espagnole;
São Paulo	Wàll:Dëkk;Wàll:Breesil;
Duusub sin	Wàll:nattpuxtal;Wàll:duus;
Njeexitu joule	Wàll:mbëj;Wàll:kàttan;
Osasco	Wàll:Breesil;
Jéeri ji	Wàll:Suuf;
Concepción (Ciili)	Wàll:Ciili;
Pichilemu	Wàll:Ciili;
Angolemi	Wàll:Ciipër;
Monzón	Wàll:Ispaañ;
Caracas	Wàll:Benesuwela;Wàll:Péy;
Mérida, Benesuwela	Wàll:Dëkki Benesuwela;
Santiago Tequixquiac	Wàll:Dëkki Meksik;
Truong Tan Sang	Wàll:Wiyetnaam;
Paltoga	Wàll:Riisi;
Tequixquiac	Wàll:Meksik;
Moshchena	Wàll:Ukreen;
Pachuca de Soto	Wàll:Meksik;
Lebu	Wàll:Waasoy Senegaal;
Rafael Correa	Wàll:Ekwadoor;
Pitax	Wàll:Picc;
Nha Trang	Wàll:Wiyetnaam;
Bien Hoa	Wàll:Wiyetnaam;
Mustafa Kemal Atatürk	Wàll:Tirki|Atatuerk;Wàll:Nit|Atatuerk;
Ba Ria	Wàll:Wiyetnaam;
Thanh Hoa	Wàll:Wiyetnaam;
Phan Thiet	Wàll:Wiyetnaam;
Ben Tre	Wàll:Wiyetnaam;
Oblaznytsia	Wàll:Ukreen;
Krushynka	Wàll:Ukreen;
Niccolò Cusano University	Wàll:Itaali;
Vesoul	Wàll:Faraas;
Queen	Wàll:Woy;
Corbin Bleu	Wàll:Dun;
Coreca	Wàll:Itaali;
Ba Don	Wàll:Wiyetnaam;
Siligo	Wàll:Itaali;
The Doors	Wàll:Woy;
Radio Studio 54 Network	Wàll:Station Rajo Itaali;Wàll:Rajo;
Locri	Wàll:Itaali;
Trojany	Wàll:Poloñ;
Anna Rita Del Piano	Wàll:Njàngat;Wàll:Woy;Wàll:Itaali;
Benedicta Boccoli	Wàll:Njàngat;Wàll:Woy;Wàll:Itaali;
Bochotnica	Wàll:Poloñ;
Budka Suflera	Wàll:Woy;
Royuwaay:Jumtukaayu layout	Wàll:Royuwaay;
Jàngoroy Ebola	Wàll:Ebola;
Niseeria	Wàll:Réew;Wàll:Afrig;Wàll:Sowwu Afrig;
Julius Caesar	Wàll:Taariix;
Duran Duran	Wàll:Woy;
Ronald Reagan	Wàll:Diiwaan yu Bennoo;
RMF FM	Wàll:Station Rajo Poloñ;Wàll:Rajo;
Mindelo	Wàll:Dëkk;Wàll:Kap Weer;
Royuwaay:El	Wàll:Royuwaay;
Royuwaay:Pt	Wàll:Royuwaay;
Royuwaay:Commonscat	Commons:{{#if:{{{1|}}}|{{{1}}}|{{PAGENAME}}}}|{{#if:{{{2|}}}|{{{2}}}|{{PAGENAME}}}};Royuwaay|Commons;
Korent	Wàll:Dëkk;Wàll:Girees;
Arara	Wàll:Breesil;
Łobez	Wàll: Poloñ;
Santiag	Wàll:Ciili;
Espargos	Wàll:Dëkk;Wàll:Kap Weer;
Module:Infobox	Articles which use infobox templates with no data rows;Pages which use embedded infobox templates with the title parameter;
Module:InfoboxImage	Pages using infoboxes with thumbnail images;
Module:Wikidata	Called function 'Dump' from module Wikidata;
Module:Message box	%s|%s;%s;
Module:Citation/CS1	--------------------------< L A N G U A G E _ P A R A M E T E R >------------------------------------------

Get language name from ISO639-1 code value provided.  If a code is valid use the returned name; if not, then use the value that was provided with the language parameter.

There is an exception.  There are three ISO639-1 codes for Norewegian language variants.  There are two official variants: Norwegian Bokmål (code 'nb') and
Norwegian Nynorsk (code 'nn').  The third, code 'no',  is defined by ISO639-1 as 'Norwegian' though in Norway this is pretty much meaningless.  However, it appears
that on enwiki, editors are for the most part unaware of the nb and nn variants (compare page counts for these variants at Articles with non-English-language external links.

Because Norwegian Bokmål is the most common language variant, Media wiki has been modified to return Norwegian Bokmål for ISO639-1 code 'no'. Here we undo that and
return 'Norwegian' when editors use |language=no.  We presume that editors don't know about the variants or can't descriminate between them.

See Help talk:Citation Style_1#An ISO 639-1 language name test

When |language= contains a valid ISO639-1 code, the page is assigned to the category for that code: Norwegian-language sources (no) if
the page is a mainspace page and the ISO639-1 code is not 'en'.  Similarly, if the  parameter is |language=Norwegian, it will be categorized in the same way.

This function supports multiple languages in the form |language=nb, French, th where the language names or codes are separated from each other by commas.

;--------------------------< E X T R A _ T E X T _ I N _ P A G E _ C H E C K >------------------------------

Adds page to CS1 maint: extra text if |page= or |pages= has what appears to be some form of p. or pp. 
abbreviation in the first characters of the parameter content.

check Page and Pages for extraneous p, p., pp, and pp. at start of parameter value:
	good pattern: '^P[^%.P%l]' matches when |page(s)= begins PX or P# but not Px where x and X are letters and # is a dgiit
	bad pattern: '^[Pp][Pp]' matches matches when |page(s)= begins pp or pP or Pp or PP

;:' .. v ..'|link;' .. v ..';' .. v ..';' .. v ..';
Module:Citation/CS1/Configuration	Pages containing links to subscription-only content;Pages with login required references or sources;
Royuwaay:Infobox football club	football team templates which use images;football team templates which use short name parameter;
Maad a Sinig Ama Juuf Njeelane Faye Juuf	Wàll:Cosaan;Wàll:Niti senegaal;Wàll:Niti Gàmbi;Wàll:Taariixu senegaal;Wàll:Cosaan Séeréer;Wàll: Séeréer;Wàll:Taariixu Gàmbi;
Angela Cavagna	Wàll:Njàngat;Wàll:Woy;Wàll:Itaali;
Santiago (Kap Weer)	Wàll:Nekk;Wàll:Kap Weer;
São Vicente (Kap Weer)	Wàll:Nekk;Wàll:Kap Weer;
Sudaan gu Bëj-saalum	Wàll:Réew;Wàll:Afrig;
Fanny Cadeo	Wàll:Njàngat;Wàll:Woy;Wàll:Itaali;
Barbara Chiappini	Wàll:Njàngat;Wàll:Woy;Wàll:Itaali;
Fogo (Kap Weert)	Wàll:Nekk;Wàll:Kap Weer;
Royuwaay:Wikbaatukaay	Royuwaay|Wikbaatukaay;
Royuwaay:Div col	Pages using div col with small parameter;Royuwaay;
Royuwaay:Div col end	Wàll:Royuwaay;
Momoko Kōchi	Wàll:Sapoŋ;Wàll:Sinemaa;
Santo Antão (Kap Weert)	Wàll:Nekk;Wàll:Kap Weer;
Jerusalem	Wàll:Israayil;Wàll:Péy;
Tokyo	Wàll:Sapoŋ;Wàll:Péy;
Rio de Janeiro	Wàll:Dëkk;Wàll:Breesil;
Kyoto	Wàll:Dëkk;Wàll:Sapoŋ;
Nagoya	Wàll:Dëkk;Wàll:Sapoŋ;
Osaka	Wàll:Dëkk;Wàll:Sapoŋ;
Sapporo	Wàll:Dëkk;Wàll:Sapoŋ;
Yokohama	Wàll:Dëkk;Wàll:Sapoŋ;
Sal (Kap Weert)	Wàll:Nekk;Wàll:Kap Weer;
Assomada	Wàll:Dëkk;Wàll:Kap Weer;
Wu-ispaañ	Wàll:Junj;Wàll:Làkk;Wàll:Ispaañ;
Silin	Wàll:Ciili;
São Nicolau (Kap Weer)	Wàll:Nekk;Wàll:Kap Weer;
Porto Novo (Kap Weert)	Wàll:Dëkk;Wàll:Kap Weer;
