WÃ ll:Senegaal	WÃ ll:RÃ©ew;WÃ ll:Afrig;
WÃ ll:Asi	WÃ ll:Adduna;WÃ ll:Melosuuf;WÃ ll:Gox yi;
WÃ ll:Faraas	WÃ ll:RÃ©ew;WÃ ll:Tugal;
WÃ ll:Politig	WÃ ll:Barab biir jimbulang;
WÃ ll:Sinemaa	WÃ ll:Barab biir jimbulang;
WÃ ll:Kanadaa	WÃ ll:RÃ©ew;WÃ ll:Aamerig;
WÃ ll:XaralaymbÃ«j	WÃ ll:Xarala;
WÃ ll:Diine	WÃ ll:Barab biir jimbulang;
WÃ ll:Bunt	WÃ ll:Barab biti jimbulang;
WÃ ll:Adduna	WÃ ll:Suuf;got:ğŒ°ğŒ¹ğ‚ğŒ¸ğŒ°;
WÃ ll:Taariix	WÃ ll:Xam-xam;
WÃ ll:Gox yi	WÃ ll:Melosuuf;WÃ ll:Adduna;
WÃ ll:Taariixu Isipt	WÃ ll:Isipt;WÃ ll:Taariixu Afrig;
WÃ ll:Isipt gu yÃ gg ga	WÃ ll:Isipt;
WÃ ll:Tugal	WÃ ll:Gox yi;WÃ ll:Melosuuf;
WÃ ll:Falag	WÃ ll:Melosuuf;
WÃ ll:Royuwaayu asi	WÃ ll:Royuwaay sÃ©wÃ³garaafi;
WÃ ll:Lislaam	WÃ ll:Diine;
WÃ ll:MbÃ«jfeppal	WÃ ll:JÃ«mm;WÃ ll:Xarala;
WÃ ll:Xay	WÃ ll:Taariix;
WÃ ll:NjÃ ngat	WÃ ll:Barab biir jimbulang;WÃ ll:FÃ nn;
WÃ ll:Diwaani oseyaani	WÃ ll:oseyaani;WÃ ll:Diiwaan|Oseyaani;
WÃ ll:Oseyaani	WÃ ll:Gox yi;WÃ ll:Adduna;WÃ ll:Melosuuf;
WÃ ll:MbÃ mbulaan yi	WÃ ll:Melosuuf;WÃ ll:Suuf;
WÃ ll:AlmaaÃ±	WÃ ll:RÃ©ew;WÃ ll:Tugal;
WÃ ll:Taariixu senegaal	WÃ ll:Senegaal;WÃ ll:Taariixu Afrig;
WÃ ll yi xam-xam jÃ«me kanam ci Tugal	WÃ ll:xam-xam;WÃ ll:Tugal;
WÃ ll:Melosuufug Alseeri	WÃ ll:Melosuufug afrig|Alseeri;WÃ ll:Alseeri;
WÃ ll:LÃ kki senegaal	WÃ ll:senegaal;WÃ ll:LÃ kki Afrig;
WÃ ll:Poortorikoo	WÃ ll:Aamerig;
WÃ ll:Aamerig	WÃ ll:Gox yi;
WÃ ll:Boyutu Babel	WÃ ll:Boyutu jÃ«fÃ«ndikookat;
WÃ ll:Boyutu Babel 1	WÃ ll:Boyutu Babel;
WÃ ll:JÃ«fandikukat pt	WÃ ll:Waa-wikipedia ci lÃ kk-ak-lÃ kk|pt;
WÃ ll:JÃ«fandikukat pt-1	WÃ ll:JÃ«fandikukat pt;
WÃ ll:Waa-wikipedia ci lÃ kk-ak-lÃ kk	WÃ ll:Waa-wikipedia ci barab-ak-barab;
WÃ ll:Boyutu Babel 2	WÃ ll:Boyutu Babel;
WÃ ll:Boyutu Babel 3	WÃ ll:Boyutu Babel;
WÃ ll:Boyutu Babel 4	WÃ ll:Boyutu Babel;
WÃ ll:Boyutu Babel 5	WÃ ll:Boyutu Babel;
WÃ ll:Boyutu Babel N	WÃ ll:Boyutu Babel;
WÃ ll:Boyutu Babel 0	WÃ ll:Boyutu Babel;
WÃ ll:JÃ«fandikukat pt-3	WÃ ll:JÃ«fandikukat pt;
WÃ ll:JÃ«fandikukat pt-4	WÃ ll:JÃ«fandikukat pt;
WÃ ll:JÃ«fandikukat pt-N	WÃ ll:JÃ«fandikukat pt;
WÃ ll:JÃ«fandikukat fr	WÃ ll:Waa-wikipedia ci lÃ kk-ak-lÃ kk|fr;
WÃ ll:JÃ«fandikukat fr-N	WÃ ll:JÃ«fandikukat fr;
WÃ ll:JÃ«fandikukat en	WÃ ll:Waa-wikipedia ci lÃ kk-ak-lÃ kk|en;
WÃ ll:JÃ«fandikukat en-N	WÃ ll:JÃ«fandikukat en;
WÃ ll:JÃ«fandikukat es	WÃ ll:Waa-wikipedia ci lÃ kk-ak-lÃ kk|es;
WÃ ll:JÃ«fandikukat es-N	WÃ ll:JÃ«fandikukat es;
WÃ ll:JÃ«fandikukat de	WÃ ll:Waa-wikipedia ci lÃ kk-ak-lÃ kk|de;
WÃ ll:JÃ«fandikukat de-N	WÃ ll:JÃ«fandikukat de;
WÃ ll:JÃ«fandikukat zh	WÃ ll:Waa-wikipedia ci lÃ kk-ak-lÃ kk|zh;
WÃ ll:JÃ«fandikukat zh-N	WÃ ll:JÃ«fandikukat zh;
WÃ ll:JÃ«fandikukat ru	WÃ ll:Waa-wikipedia ci lÃ kk-ak-lÃ kk|ru;
WÃ ll:JÃ«fandikukat ru-N	WÃ ll:JÃ«fandikukat ru;
WÃ ll:JÃ«fandikukat it	WÃ ll:Waa-wikipedia ci lÃ kk-ak-lÃ kk|it;
WÃ ll:JÃ«fandikukat it-N	WÃ ll:JÃ«fandikukat it;
WÃ ll:JÃ«fandikukat nl	WÃ ll:Waa-wikipedia ci lÃ kk-ak-lÃ kk|nl;
WÃ ll:JÃ«fandikukat nl-N	WÃ ll:JÃ«fandikukat nl;
WÃ ll:JÃ«fandikukat li	WÃ ll:Waa-wikipedia ci lÃ kk-ak-lÃ kk|li;
WÃ ll:JÃ«fandikukat sk	WÃ ll:Waa-wikipedia ci lÃ kk-ak-lÃ kk|sk;
WÃ ll:JÃ«fandikukat en-0	WÃ ll:JÃ«fandikukat en;
WÃ ll:JÃ«fandikukat en-1	WÃ ll:JÃ«fandikukat en;
WÃ ll:JÃ«fandikukat en-2	WÃ ll:JÃ«fandikukat en;
WÃ ll:JÃ«fandikukat en-3	WÃ ll:JÃ«fandikukat en;
WÃ ll:JÃ«fandikukat en-4	WÃ ll:JÃ«fandikukat en;
WÃ ll:JÃ«fandikukat fr-0	WÃ ll:JÃ«fandikukat fr;
WÃ ll:JÃ«fandikukat fr-1	WÃ ll:JÃ«fandikukat fr;
WÃ ll:JÃ«fandikukat fr-2	WÃ ll:JÃ«fandikukat fr;
WÃ ll:JÃ«fandikukat fr-3	WÃ ll:JÃ«fandikukat fr;
WÃ ll:JÃ«fandikukat fr-4	WÃ ll:JÃ«fandikukat fr;
WÃ ll:JÃ«fandikukat de-0	WÃ ll:JÃ«fandikukat de;
WÃ ll:JÃ«fandikukat de-1	WÃ ll:JÃ«fandikukat de;
WÃ ll:JÃ«fandikukat de-2	WÃ ll:JÃ«fandikukat de;
WÃ ll:JÃ«fandikukat de-3	WÃ ll:JÃ«fandikukat de;
WÃ ll:JÃ«fandikukat de-5	WÃ ll:JÃ«fandikukat de;
WÃ ll:JÃ«fandikukat de-4	WÃ ll:JÃ«fandikukat de;
WÃ ll:JÃ«fandikukat es-1	WÃ ll:JÃ«fandikukat es;
WÃ ll:JÃ«fandikukat es-2	WÃ ll:JÃ«fandikukat es;
WÃ ll:JÃ«fandikukat es-3	WÃ ll:JÃ«fandikukat es;
WÃ ll:JÃ«fandikukat es-4	WÃ ll:JÃ«fandikukat es;
WÃ ll:JÃ«fandikukat it-1	WÃ ll:JÃ«fandikukat it;
WÃ ll:JÃ«fandikukat it-2	WÃ ll:JÃ«fandikukat it;
WÃ ll:JÃ«fandikukat it-3	WÃ ll:JÃ«fandikukat it;
WÃ ll:JÃ«fandikukat ru-1	WÃ ll:JÃ«fandikukat ru;
WÃ ll:JÃ«fandikukat sv	WÃ ll:Waa-wikipedia ci lÃ kk-ak-lÃ kk|sv;
WÃ ll:JÃ«fandikukat sv-1	WÃ ll:JÃ«fandikukat sv;
WÃ ll:JÃ«fandikukat ja	WÃ ll:Waa-wikipedia ci lÃ kk-ak-lÃ kk|ja;
WÃ ll:JÃ«fandikukat ja-N	WÃ ll:JÃ«fandikukat ja;
WÃ ll:JÃ«fandikukat ja-1	WÃ ll:JÃ«fandikukat ja;
WÃ ll:JÃ«fandikukat zh-1	WÃ ll:JÃ«fandikukat zh;
WÃ ll:JÃ«fandikukat ja-4	WÃ ll:JÃ«fandikukat ja;
WÃ ll:JÃ«fandikukat zh-2	WÃ ll:JÃ«fandikukat zh;
WÃ ll:JÃ«fandikukat eo	WÃ ll:Waa-wikipedia ci lÃ kk-ak-lÃ kk|eo;
WÃ ll:JÃ«fandikukat eo-2	WÃ ll:JÃ«fandikukat eo;
WÃ ll:JÃ«fandikukat eo-1	WÃ ll:JÃ«fandikukat eo;
WÃ ll:JÃ«fandikukat eo-3	WÃ ll:JÃ«fandikukat eo;
WÃ ll:JÃ«fandikukat nl-1	WÃ ll:JÃ«fandikukat nl;
WÃ ll:JÃ«fandikukat la	WÃ ll:Waa-wikipedia ci lÃ kk-ak-lÃ kk|la;
WÃ ll:JÃ«fandikukat la-3	WÃ ll:JÃ«fandikukat la;
WÃ ll:JÃ«fandikukat ko	WÃ ll:Waa-wikipedia ci lÃ kk-ak-lÃ kk|ko;
WÃ ll:JÃ«fandikukat la-1	WÃ ll:JÃ«fandikukat la;
WÃ ll:JÃ«fandikukat la-2	WÃ ll:JÃ«fandikukat la;
WÃ ll:JÃ«fandikukat af-1	WÃ ll:JÃ«fandikukat af;
WÃ ll:JÃ«fandikukat af	WÃ ll:Waa-wikipedia ci lÃ kk-ak-lÃ kk|af;
WÃ ll:JÃ«fandikukat nl-2	WÃ ll:JÃ«fandikukat nl;
WÃ ll:JÃ«fandikukat da-N	WÃ ll:JÃ«fandikukat da;
WÃ ll:JÃ«fandikukat da	WÃ ll:Waa-wikipedia ci lÃ kk-ak-lÃ kk|da;
WÃ ll:JÃ«fandikukat no-2	WÃ ll:JÃ«fandikukat no;
WÃ ll:JÃ«fandikukat no	WÃ ll:Waa-wikipedia ci lÃ kk-ak-lÃ kk|no;
WÃ ll:JÃ«fandikukat da-1	WÃ ll:JÃ«fandikukat da;
WÃ ll:JÃ«fandikukat li-1	WÃ ll:JÃ«fandikukat li;
WÃ ll:JÃ«fandikukat ro	WÃ ll:Waa-wikipedia ci lÃ kk-ak-lÃ kk|ro;
WÃ ll:PÃ©y	bn:à¦°à¦¾à¦œà¦§à¦¾à¦¨à§€;en:Capitals;gan:é¦–éƒ½;ja:é¦–éƒ½;nov:Chef-urbes;sh:Glavni gradovi;simple:Capital cities;sq:Kryeqytete;sw:Miji mikuu;yo:Oluilu;zh:é¦–éƒ½;zh-min-nan:SiÃº-toÍ˜;zh-yue:é¦–éƒ½;
WÃ ll:Junj	WÃ ll:XÃ«t wu njÃ«kk;
WÃ ll:IspaaÃ±	WÃ ll:RÃ©ew;WÃ ll:Tugal;
WÃ ll:Suwis	WÃ ll:RÃ©ew;WÃ ll:Tugal;
WÃ ll:LÃ kk	WÃ ll:Xam-xam;
WÃ ll:Nguur-Yu-Bennoo	WÃ ll:RÃ©ew;WÃ ll:Tugal;
WÃ ll:Xam-xam	WÃ ll:Barab biir jimbulang;
WÃ ll:Barab biir jimbulang	WÃ ll:XÃ«t wu njÃ«kk;
WÃ ll:Saytubiddiw	WÃ ll:Xam-xam;
WÃ ll:Itaali	WÃ ll:RÃ©ew;WÃ ll:Tugal;
WÃ ll:Girees	WÃ ll:Tugal;WÃ ll:RÃ©ew;
WÃ ll:Xayma	WÃ ll:Xam-xam;
WÃ ll:Paj	WÃ ll:Xam-xam;
WÃ ll:Xarala	WÃ ll:Xam-xam;
WÃ ll:JÃ«mm	WÃ ll:Xam-xam;
WÃ ll:Leeral BiibÃ«l	WÃ ll:Diine;
WÃ ll:Belaarus	WÃ ll:RÃ©ew;WÃ ll:Tugal;
WÃ ll:Bulgaari	WÃ ll:RÃ©ew;WÃ ll:Tugal;
WÃ ll:Melo	WÃ ll:JÃ«mm;
WÃ ll:RÃ©ewum Cek	WÃ ll:Tugal;WÃ ll:RÃ©ew;
WÃ ll:Moldaawi	WÃ ll:Tugal;WÃ ll:RÃ©ew;
WÃ ll:PoloÃ±	WÃ ll:Tugal;WÃ ll:RÃ©ew;
WÃ ll:Montenegro	WÃ ll:RÃ©ew;WÃ ll:Tugal;
WÃ ll:Portugaal	WÃ ll:RÃ©ew;WÃ ll:Tugal;
WÃ ll:San Marino	WÃ ll:RÃ©ew;WÃ ll:Tugal;
WÃ ll:Seerbi	WÃ ll:RÃ©ew;WÃ ll:Tugal;
WÃ ll:Tirki	WÃ ll:RÃ©ew;WÃ ll:Tugal;WÃ ll:Asi;
WÃ ll:Beljik	WÃ ll:RÃ©ew;WÃ ll:Tugal;
WÃ ll:Watikaa	WÃ ll:RÃ©ew;WÃ ll:Tugal;
WÃ ll:Liechtenstein	WÃ ll:RÃ©ew;WÃ ll:Tugal;
WÃ ll:Esloweeni	WÃ ll:RÃ©ew;WÃ ll:Tugal;
WÃ ll:Jeoorji	WÃ ll:RÃ©ew;WÃ ll:Tugal;WÃ ll:Asi;
WÃ ll:Aserbayjaan	WÃ ll:RÃ©ew;WÃ ll:Tugal;WÃ ll:Asi;
WÃ ll:Kasakistaan	WÃ ll:RÃ©ew;WÃ ll:Tugal;WÃ ll:Asi;
WÃ ll:Monaako	WÃ ll:RÃ©ew;WÃ ll:Tugal;
WÃ ll:Luksambuur	WÃ ll:RÃ©ew;WÃ ll:Tugal;
WÃ ll:Jimbulang	WÃ ll:Xam-xam;WÃ ll:NjÃ ngale;
WÃ ll:JÃ«fandikukat ru-4	WÃ ll:JÃ«fandikukat ru;
WÃ ll:JÃ«fandikukat lv	WÃ ll:Waa-wikipedia ci lÃ kk-ak-lÃ kk|lv;
WÃ ll:JÃ«fandikukat ar	WÃ ll:Waa-wikipedia ci lÃ kk-ak-lÃ kk|ar;
WÃ ll:Koom-koom	WÃ ll:Xam-xam;
WÃ ll:Ciili	WÃ ll:Aamerig;WÃ ll:RÃ©ew;
WÃ ll:Boliibi	WÃ ll:RÃ©ew;WÃ ll:Aamerig;
WÃ ll:Peru	WÃ ll:RÃ©ew;WÃ ll:Aamerig;
WÃ ll:Benesuwela	WÃ ll:RÃ©ew;WÃ ll:Aamerig;
WÃ ll:Meksik	WÃ ll:RÃ©ew;WÃ ll:Aamerig;
WÃ ll:Melosuuf	WÃ ll:Xam-xam;
WÃ ll:JÃ«fandikukat ksh	WÃ ll:Waa-wikipedia ci lÃ kk-ak-lÃ kk|ksh;
WÃ ll:JÃ«fandikukat ksh-N	WÃ ll:JÃ«fandikukat ksh;
WÃ ll:Arminaat	WÃ ll:JÃ«mm;
WÃ ll:JÃ«fandikukat ru-2	WÃ ll:JÃ«fandikukat ru;
WÃ ll:Football	WÃ ll:Sport;
WÃ ll:Sport	WÃ ll:Barab biir jimbulang;
WÃ ll:Ndox	WÃ ll:Simi;
WÃ ll:Dundat yi	WÃ ll:Xam-xam;
WÃ ll:JÃ«fandikukat pl-N	WÃ ll:JÃ«fandikukat pl;
WÃ ll:JÃ«fandikukat pl	WÃ ll:Waa-wikipedia ci lÃ kk-ak-lÃ kk|pl;
WÃ ll:Niseeria	WÃ ll:RÃ©ew;WÃ ll:Afrig;
WÃ ll:Botswana	WÃ ll:RÃ©ew;WÃ ll:Afrig;
WÃ ll:Bene	WÃ ll:RÃ©ew;WÃ ll:Afrig;
WÃ ll:Angolaa	WÃ ll:RÃ©ew;WÃ ll:Afrig;
WÃ ll:Alseeri	WÃ ll:RÃ©ew;WÃ ll:Afrig;
WÃ ll:Afrig gu BÃ«j-saalum	WÃ ll:RÃ©ew;WÃ ll:Afrig;
WÃ ll:Kubaa	WÃ ll:RÃ©ew;WÃ ll:Aamerig;
WÃ ll:Arsantin	WÃ ll:RÃ©ew;WÃ ll:Aamerig;
WÃ ll:Afrig	WÃ ll:Melosuuf;WÃ ll:Adduna;WÃ ll:Gox yi;
WÃ ll:Diwaani Aamerig	WÃ ll:Diiwaan|aamerig;
WÃ ll:Ekwadoor	WÃ ll:RÃ©ew;WÃ ll:Aamerig;
WÃ ll:Koloombi	WÃ ll:RÃ©ew;WÃ ll:Aamerig;
WÃ ll:Uruguwaay	WÃ ll:RÃ©ew;WÃ ll:Aamerig;
WÃ ll:Jamayka	WÃ ll:RÃ©ew;WÃ ll:Aamerig;
WÃ ll:Nikaraaguwa	WÃ ll:RÃ©ew;WÃ ll:Aamerig;
WÃ ll:Guyaana	WÃ ll:RÃ©ew;WÃ ll:Aamerig;
WÃ ll:Taariixu Asi	ja:ã‚¢ã‚¸ã‚¢å²;simple:History of Asia;zh-yue:äºæ´²å²;zh:äºšæ´²å†å²;
WÃ ll:Taariixu Aamerig	WÃ ll:Taariix;WÃ ll:Aamerig;
WÃ ll:JÃ«fandikukat sk-1	WÃ ll:JÃ«fandikukat sk;
WÃ ll:JÃ«fandikukat eu-N	WÃ ll:JÃ«fandikukat eu;
WÃ ll:JÃ«fandikukat eu	WÃ ll:Waa-wikipedia ci lÃ kk-ak-lÃ kk|eu;
WÃ ll:JÃ«fandikukat ca-4	WÃ ll:JÃ«fandikukat ca;
WÃ ll:JÃ«fandikukat ca	WÃ ll:Waa-wikipedia ci lÃ kk-ak-lÃ kk|ca;
WÃ ll:JÃ«fandikukat cs-N	WÃ ll:JÃ«fandikukat cs;
WÃ ll:JÃ«fandikukat cs	WÃ ll:Waa-wikipedia ci lÃ kk-ak-lÃ kk|cs;
WÃ ll:JÃ«fandikukat hu-N	WÃ ll:JÃ«fandikukat hu;
WÃ ll:JÃ«fandikukat hu	WÃ ll:Waa-wikipedia ci lÃ kk-ak-lÃ kk|hu;
WÃ ll:JÃ«fandikukat fi-N	WÃ ll:JÃ«fandikukat fi;
WÃ ll:JÃ«fandikukat fi	WÃ ll:Waa-wikipedia ci lÃ kk-ak-lÃ kk|fi;
WÃ ll:JÃ«fandikukat id-3	WÃ ll:JÃ«fandikukat id;
WÃ ll:JÃ«fandikukat id	WÃ ll:Waa-wikipedia ci lÃ kk-ak-lÃ kk|id;
WÃ ll:JÃ«fandikukat el-1	WÃ ll:JÃ«fandikukat el;
WÃ ll:JÃ«fandikukat el	WÃ ll:Waa-wikipedia ci lÃ kk-ak-lÃ kk|el;
WÃ ll:JÃ«fandikukat io-3	WÃ ll:JÃ«fandikukat io;
WÃ ll:JÃ«fandikukat io	WÃ ll:Waa-wikipedia ci lÃ kk-ak-lÃ kk|io;
WÃ ll:JÃ«fandikukat ia-2	WÃ ll:JÃ«fandikukat ia;
WÃ ll:JÃ«fandikukat ia	WÃ ll:Waa-wikipedia ci lÃ kk-ak-lÃ kk|ia;
WÃ ll:JÃ«fandikukat et	WÃ ll:Waa-wikipedia ci lÃ kk-ak-lÃ kk|et;
WÃ ll:JÃ«fandikukat et-1	WÃ ll:JÃ«fandikukat et;
WÃ ll:JÃ«fandikukat lb-1	WÃ ll:JÃ«fandikukat lb;
WÃ ll:JÃ«fandikukat lb	WÃ ll:Waa-wikipedia ci lÃ kk-ak-lÃ kk|lb;
WÃ ll:JÃ«fandikukat hi-1	WÃ ll:JÃ«fandikukat hi;
WÃ ll:JÃ«fandikukat hi	WÃ ll:Waa-wikipedia ci lÃ kk-ak-lÃ kk|hi;
WÃ ll:JÃ«fandikukat ar-1	WÃ ll:JÃ«fandikukat ar;
WÃ ll:JÃ«fandikukat ka-1	WÃ ll:JÃ«fandikukat ka;
WÃ ll:JÃ«fandikukat ka	WÃ ll:Waa-wikipedia ci lÃ kk-ak-lÃ kk|ka;
WÃ ll:JÃ«fandikukat vo-1	WÃ ll:JÃ«fandikukat vo;
WÃ ll:JÃ«fandikukat vo	WÃ ll:Waa-wikipedia ci lÃ kk-ak-lÃ kk|vo;
WÃ ll:JÃ«fandikukat yi-2	WÃ ll:JÃ«fandikukat yi;
WÃ ll:JÃ«fandikukat yi	WÃ ll:Waa-wikipedia ci lÃ kk-ak-lÃ kk|yi;
WÃ ll:Nguuri Afrig	WÃ ll:Afrig;
WÃ ll:Mongoli	WÃ ll:Asi;WÃ ll:RÃ©ew;
WÃ ll:Filmi	WÃ ll:Sinemaa;
WÃ ll:Isipt	WÃ ll:RÃ©ew;WÃ ll:Afrig;WÃ ll:Asi;
WÃ ll:Siri	WÃ ll:RÃ©ew;WÃ ll:Asi;
WÃ ll:Breesil	WÃ ll:RÃ©ew;WÃ ll:Aamerig;
WÃ ll:Yooni Senegaal	WÃ ll:diiney Senegaal;
WÃ ll:Diiney Senegaal	WÃ ll:Senegaal;
WÃ ll:JÃ«fandikukat sw	WÃ ll:Waa-wikipedia ci lÃ kk-ak-lÃ kk|sw;
WÃ ll:JÃ«fandikukat sw-N	WÃ ll:JÃ«fandikukat sw;
WÃ ll:Albaani	WÃ ll:RÃ©ew;WÃ ll:Tugal;
WÃ ll:Tansani	WÃ ll:RÃ©ew;WÃ ll:Afrig;
WÃ ll:SapoÅ‹	WÃ ll:RÃ©ew;WÃ ll:Asi;
WÃ ll:GÃ©ej	WÃ ll:Melosuuf;
WÃ ll:Alxuraan	WÃ ll:Lislaam;
WÃ ll:Xibaar	WÃ ll:Barab biir jimbulang;
WÃ ll:Global bot	WÃ ll:Bot Wikipedia;
WÃ ll:Local bot	WÃ ll:Bot Wikipedia;
WÃ ll:Inactif bot	WÃ ll:Bot Wikipedia;
WÃ ll:Riisi	WÃ ll:RÃ©ew;WÃ ll:Tugal;WÃ ll:Asi;
WÃ ll:Wiyetnaam	WÃ ll:RÃ©ew;WÃ ll:Asi;
WÃ ll:JÃ«fandikukat pl-1	WÃ ll:JÃ«fandikukat pl;
WÃ ll:Noorwees	WÃ ll:RÃ©ew;WÃ ll:Tugal;
WÃ ll:LÃ kki Afrig	WÃ ll:LÃ kk;WÃ ll:Afrig;
WÃ ll:Koom-koomu Afrig	WÃ ll:Koom-koom;WÃ ll:Afrig;
WÃ ll:GÃ ncax	WÃ ll:Dundat yi;
WÃ ll:Irlaand	WÃ ll:RÃ©ew;WÃ ll:Tugal;
WÃ ll:Woy	WÃ ll:Barab biir jimbulang;
WÃ ll:Finlaand	WÃ ll:RÃ©ew;WÃ ll:Tugal;
WÃ ll:Kamerun	WÃ ll:RÃ©ew;WÃ ll:Afrig;
WÃ ll:Baati wolof	WÃ ll:Wolof;
WÃ ll:Wolof	WÃ ll:LÃ kki senegaal;
WÃ ll:Andoor	WÃ ll:RÃ©ew;WÃ ll:Tugal;
WÃ ll:Cuub	WÃ ll:Barab biir jimbulang;
WÃ ll:Danmaark	WÃ ll:RÃ©ew;WÃ ll:Tugal;
WÃ ll:Estooni	WÃ ll:RÃ©ew;WÃ ll:Tugal;
WÃ ll:Islaand	WÃ ll:RÃ©ew;WÃ ll:Tugal;
WÃ ll:Korwaasi	WÃ ll:RÃ©ew;WÃ ll:Tugal;
WÃ ll:LetÃ³oni	WÃ ll:RÃ©ew;WÃ ll:Tugal;
WÃ ll:Lituwaani	WÃ ll:RÃ©ew;WÃ ll:Tugal;
WÃ ll:Malt	WÃ ll:RÃ©ew;WÃ ll:Tugal;
WÃ ll:RÃ©ewum Maseduwaan	WÃ ll:RÃ©ew;WÃ ll:Tugal;
WÃ ll:Ukreen	WÃ ll:RÃ©ew;WÃ ll:Tugal;
WÃ ll:Eslowaaki	WÃ ll:RÃ©ew;WÃ ll:Tugal;
WÃ ll:CiipÃ«r	WÃ ll:RÃ©ew;WÃ ll:Tugal;
WÃ ll:Bosni	WÃ ll:RÃ©ew;WÃ ll:Tugal;
WÃ ll:Armeeni	WÃ ll:RÃ©ew;WÃ ll:Tugal;WÃ ll:Asi;
WÃ ll:Endoneesi	WÃ ll:RÃ©ew;WÃ ll:Asi;
WÃ ll:Ayiti	WÃ ll:RÃ©ew;WÃ ll:Aamerig;
WÃ ll:Gana	WÃ ll:RÃ©ew;WÃ ll:Afrig;
WÃ ll:Afganistaan	WÃ ll:RÃ©ew;WÃ ll:Asi;
WÃ ll:Angila	WÃ ll:RÃ©ew;WÃ ll:Aamerig;
WÃ ll:Antigua ak Barbuda	WÃ ll:RÃ©ew;WÃ ll:Aamerig;
WÃ ll:Araabi Sawdit	WÃ ll:RÃ©ew;WÃ ll:Asi;
WÃ ll:Xam-xamu nosukaay	WÃ ll:Xarala;WÃ ll:Xam-xam;
WÃ ll:Mbootaay yu Senegal	WÃ ll:Senegaal;
WÃ ll:Xam-xamu suuf si ak jawwu ji	WÃ ll:Xam-xam;
WÃ ll:Dundug Seex Ahmadu Bamba	WÃ ll:yoonu murit;
WÃ ll:Buruundi	WÃ ll:RÃ©ew;WÃ ll:Afrig;
WÃ ll:Kap Weer	WÃ ll:RÃ©ew;WÃ ll:Afrig;
WÃ ll:TogÃ³o	WÃ ll:RÃ©ew;WÃ ll:Afrig;
WÃ ll:Tiniisi	WÃ ll:RÃ©ew;WÃ ll:Afrig;
WÃ ll:Namibi	WÃ ll:RÃ©ew;WÃ ll:Afrig;
WÃ ll:GÃ nnaar	WÃ ll:RÃ©ew;WÃ ll:Afrig;
WÃ ll:Ã“straali	WÃ ll:RÃ©ew;WÃ ll:Oseyaani;
WÃ ll:Jordaani	WÃ ll:RÃ©ew;WÃ ll:Asi;
WÃ ll:Siin	WÃ ll:RÃ©ew;WÃ ll:Asi;
WÃ ll:Banglaades	WÃ ll:RÃ©ew;WÃ ll:Asi;
WÃ ll:End	WÃ ll:RÃ©ew;WÃ ll:Asi;
WÃ ll:Iraan	WÃ ll:RÃ©ew;WÃ ll:Asi;
WÃ ll:Iraak	WÃ ll:RÃ©ew;WÃ ll:Asi;
WÃ ll:Filipiin	WÃ ll:RÃ©ew;WÃ ll:Asi;
WÃ ll:GÃ mbi	WÃ ll:RÃ©ew;WÃ ll:Afrig;
WÃ ll:Usbekistaan	WÃ ll:RÃ©ew;WÃ ll:Asi;
WÃ ll:Yaman	WÃ ll:RÃ©ew;WÃ ll:Asi;
WÃ ll:Royuwaay Coord	WÃ ll:Royuwaay sÃ©wÃ³garaafi| ;
WÃ ll:Burkinaa Faaso	WÃ ll:RÃ©ew;WÃ ll:Afrig;
WÃ ll:Aakimoo jawwu ji	WÃ ll:Xarala;WÃ ll:Saytubiddiw;
WÃ ll:GaboÅ‹	WÃ ll:RÃ©ew;WÃ ll:Afrig;
WÃ ll:Komoor	WÃ ll:RÃ©ew;WÃ ll:Afrig;
WÃ ll:Infobox	WÃ ll:Royuwaay;
WÃ ll:Onduras	WÃ ll:RÃ©ew;WÃ ll:Aamerig;
WÃ ll:Kataar	WÃ ll:RÃ©ew;WÃ ll:Asi;
WÃ ll:Cadd	WÃ ll:RÃ©ew;WÃ ll:Afrig;
WÃ ll:Lesoto	WÃ ll:RÃ©ew;WÃ ll:Afrig;
WÃ ll:Saambi	WÃ ll:RÃ©ew;WÃ ll:Afrig;
WÃ ll:Israayil	WÃ ll:RÃ©ew;WÃ ll:Asi;
WÃ ll:Salbadoor	WÃ ll:RÃ©ew;WÃ ll:Aamerig;
WÃ ll:Nauru	WÃ ll:RÃ©ew;WÃ ll:Oseyaani;
WÃ ll:KÃ ttan	WÃ ll:JÃ«mm;
WÃ ll:Neeg	WÃ ll:Xarala;ja:å»ºç¯‰ç‰©;
WÃ ll:Royuwaay diine	WÃ ll:Royuwaay;WÃ ll:Diine;
WÃ ll:Suti	WÃ ll:Xarala;en:Tools;ja:é“å…·;zh:å·¥å…·;
WÃ ll:WaaÃ±	WÃ ll:KÃ«r;
WÃ ll:KÃ«r	WÃ ll:Neeg;
WÃ ll:Rab	WÃ ll:Dundat yi;
WÃ ll:Suuf	WÃ ll:Melosuuf;
WÃ ll:Moto	WÃ ll:Xarala;
WÃ ll:Romaani	WÃ ll:RÃ©ew;WÃ ll:Tugal;
WÃ ll:Diiwaani dott	WÃ ll:Diiwaan;
WÃ ll:Diiwaan	WÃ ll:Melosuuf;
WÃ ll:LÃ kki Niseer-CÃ³ngoo	WÃ ll:LÃ kki Afrig;
WÃ ll:Simbaawee	WÃ ll:RÃ©ew;WÃ ll:Afrig;
WÃ ll:Omaan	WÃ ll:RÃ©ew;WÃ ll:Asi;
WÃ ll:Nepaal	WÃ ll:RÃ©ew;WÃ ll:Asi;
WÃ ll:Libi	WÃ ll:RÃ©ew;WÃ ll:Afrig;
WÃ ll:Maldiif	WÃ ll:RÃ©ew;
WÃ ll:Malawi	WÃ ll:RÃ©ew;WÃ ll:Afrig;
WÃ ll:Suweed	WÃ ll:RÃ©ew;WÃ ll:Tugal;
WÃ ll:Wallis ak Futuna	WÃ ll:Faraas;WÃ ll:Dun;
WÃ ll:Dencukaay	WÃ ll:Jimbulang;
WÃ ll:GÏŒor	WÃ ll:Rab;
WÃ ll:DÃ«kki Senegaal	WÃ ll:DÃ«kk;WÃ ll:Senegaal;
WÃ ll:Sao Tome ak Principe	WÃ ll:RÃ©ew;WÃ ll:Afrig;
WÃ ll:NjÃ ngale	WÃ ll:Barab biir jimbulang;
WÃ ll:Yoon	WÃ ll:Barab biir jimbulang;
WÃ ll:Suwaasilaand	WÃ ll:RÃ©ew;WÃ ll:Afrig;
WÃ ll:Yay	WÃ ll:Melosuuf;
WÃ ll:GunÃ³or	WÃ ll:Rab;
WÃ ll:JÃ©n	en:Fish]

[[WÃ ll:Rab;
WÃ ll:Jokkoo	WÃ ll:Xarala;
WÃ ll:Cosaan	WÃ ll:Barab biir jimbulang;
WÃ ll:Bahrayni	WÃ ll:RÃ©ew;WÃ ll:Asi;
WÃ ll:Xeltu	WÃ ll:Barab biir jimbulang;
WÃ ll:Imaarati Araab yu Bennoo	WÃ ll:RÃ©ew;WÃ ll:Asi;
WÃ ll:Maleesi	WÃ ll:RÃ©ew;WÃ ll:Asi;
WÃ ll:Jamono	WÃ ll:JÃ«mm;
WÃ ll:Weeri at mi	WÃ ll:Arminaat;
WÃ ll:Samwie	WÃ ll:Weeri at mi;
WÃ ll:Bokktekki	WÃ ll:Barab biir jimbulang;
WÃ ll:Suwe	WÃ ll:Weeri at mi;
WÃ ll:Awril	WÃ ll:Weeri at mi;
WÃ ll:Fewirie	WÃ ll:Weeri at mi;
WÃ ll:Maars	WÃ ll:Weeri at mi;
WÃ ll:Mee	WÃ ll:Weeri at mi;
WÃ ll:Sulet	WÃ ll:Weeri at mi;
WÃ ll:Ut	WÃ ll:Weeri at mi;
WÃ ll:Royuwaayu weer	WÃ ll:Royuwaayu jÃ«mm;
WÃ ll:Royuwaayu jÃ«mm	WÃ ll:royuwaay;
WÃ ll:Sattumbar	WÃ ll:Weeri at mi;
WÃ ll:Oktoobar	WÃ ll:Weeri at mi;
WÃ ll:Nowembar	WÃ ll:Weeri at mi;
WÃ ll:Disambar	WÃ ll:Weeri at mi;
WÃ ll:Weeri wolof	WÃ ll:arminaat;
WÃ ll:Xarey Ã dduna	WÃ ll:xare;
WÃ ll:Xare	WÃ ll:Taariix;
WÃ ll:Royuwaayu melosuuf	WÃ ll:royuwaay;
WÃ ll:NjÃ«kk-taariix	WÃ ll:Taariix;
WÃ ll:FÃ nn	WÃ ll:caada;
WÃ ll:Caada	WÃ ll:jimbulang;
WÃ ll:SÃ©mbi Wikimedia Fondation	WÃ ll:Wikimedia;
WÃ ll:Wikimedia	WÃ ll:barab biir jimbulang;
WÃ ll:Baatukaay	WÃ ll:njÃ ngale;
WÃ ll:Jibuti	WÃ ll:rÃ©ew;
WÃ ll:Eritere	WÃ ll:rÃ©ew;
WÃ ll:Ecoopi	WÃ ll:RÃ©ew;
WÃ ll:KeeÃ±aa	WÃ ll:rÃ©ew;
WÃ ll:Ugandaa	WÃ ll:RÃ©ew;
WÃ ll:Madagaskaar	WÃ ll:rÃ©ew;
WÃ ll:Mosambik	WÃ ll:RÃ©ew;
WÃ ll:Ruwandaa	WÃ ll:RÃ©ew;
WÃ ll:Seysel	WÃ ll:RÃ©ew;
WÃ ll:Somali	WÃ ll:RÃ©ew;
WÃ ll:RÃ©ewum Diggu Afrig	WÃ ll:RÃ©ew;
WÃ ll:KongÃ³o	WÃ ll:rÃ©ew;
WÃ ll:Gineg yamoo	WÃ ll:rÃ©ew;
WÃ ll:PÃ©eyi afrig	WÃ ll:melosuufug afrig;
WÃ ll:Marok	WÃ ll:RÃ©ew;
WÃ ll:Sudaan	WÃ ll:RÃ©ew;
WÃ ll:Royuwaay xam-xamu nosukaay	WÃ ll:royuwaay;
WÃ ll:Barab bu tolluwaay bu njÃ«kk	WÃ ll:Xam-xamu nosukaay;
WÃ ll:Kanaari	WÃ ll:ispaaÃ±;
WÃ ll:Dawaanu mbÃ«j	WÃ ll:mbÃ«j;
WÃ ll:MbÃ«j	WÃ ll:MbÃ«jbijjaakon;
WÃ ll:JÃ«mmu saal	WÃ ll:JÃ«mm;
WÃ ll:MbÃ«jbijjaakon	WÃ ll:jÃ«mm;
WÃ ll:Bijjaakon	WÃ ll:mbÃ«jbijjaakon;
WÃ ll:Wuutuloxo yu mbÃ«j	WÃ ll:xaralaymbÃ«j;
WÃ ll:Raaya	RÃ©ew;
WÃ ll:Nit	WÃ ll:;
WÃ ll:Yaram	WÃ ll:nit;WÃ ll:jÃ«mm;
WÃ ll:Kemi jÃ«mm	WÃ ll:JÃ«mm;en:Physical quantities;ja:ç‰©ç†é‡;nov:Fisikal quantitates;simple:Physical quantity;zh:ç‰©ç†é‡;zh-min-nan:BuÌt-lÃ­-liÅng;
WÃ ll:JÃ«fandikukat tr	WÃ ll:Waa-wikipedia ci lÃ kk-ak-lÃ kk|tr;
WÃ ll:JÃ«fandikukat tr-N	WÃ ll:JÃ«fandikukat tr;
WÃ ll:Picc	WÃ ll:BÃ yyima;
WÃ ll:MbÃ«jtekkaaral	WÃ ll:MbÃ«jbijjaakon;
WÃ ll:Nattpuxtal	WÃ ll:xayma;
WÃ ll:Duus	WÃ ll:jÃ«mm;
WÃ ll:Mbootaayi fÃ nn	WÃ ll:fÃ nn;
WÃ ll:DÃ«kki Benesuwela	WÃ ll:DÃ«kk;WÃ ll:Benesuwela;
WÃ ll:JÃ«fandikukat uk	WÃ ll:Waa-wikipedia ci lÃ kk-ak-lÃ kk|uk;
WÃ ll:JÃ«fandikukat uk-N	WÃ ll:JÃ«fandikukat uk;
WÃ ll:Ebola	WÃ ll:JÃ ngoro;
WÃ ll:Pac	WÃ ll:xam-xam;
WÃ ll:JÃ ngoro	WÃ ll:Pac;
WÃ ll:Sowwu Afrig	WÃ ll:RÃ©ew;
WÃ ll:Niti GÃ mbi	WÃ ll:GÃ mbi;
WÃ ll:SÃ©erÃ©er	WÃ ll:Niti senegaal;WÃ ll:Niti GÃ mbi;WÃ ll:Niti GÃ nnaar;WÃ ll:Niti Afrig;
WÃ ll:Taariixu GÃ mbi	WÃ ll:Taariixu Afrig;
WÃ ll:Cosaan SÃ©erÃ©er	WÃ ll:SÃ©erÃ©er;WÃ ll:Taariixu senegaal;WÃ ll:Taariixu GÃ mbi;WÃ ll:Taariixu Afrig;WÃ ll:Taariixu GÃ nnaar;
WÃ ll:Taariixu GÃ nnaar	WÃ ll:GÃ nnaar;
WÃ ll:Niti Afrig	WÃ ll:Afrig;
WÃ ll:Niti GÃ nnaar	WÃ ll:GÃ nnaar;
